山林 (さんりん): (1) Bergwald, Bergforst, (2) Berge und Wälder
成立 (せいりつ): (1) Zustandekommen, Entstehung, (2) Vollendung, Abschluss, Verwirklichung, (3) Formierung, Organisation, (1) zustande kommen, entstehen, (2) vollendet sein, abgeschlossen werden, (3) verwirklicht werden
ナンバー: (1) Nummer, Zahl, (2) Nummer, Ausgabe, (3) Nummer, Musikstück, (4) Autokennzeichen, Autonummer, Nummernschild
存じる (ぞんじる): wissen, sich etw. bewusst sein, denken
温まる (あたたまる): warm werden, sich erwärmen, sich wärmen, warm werden, (1) warm werden, sich erwärmen, sich erhitzen, (2) Geld sparen, Vermögen ansammeln, reich werden
出入り (でいり): (1) Ein‑ und Ausgehen, (2) Einnahmen und Ausgaben, (3) Auszackung, (1) Ein‑ und Ausgehen, Kommen und Gehen, Verkehr, (2) Einnahmen und Ausgaben, (3) Auf‑ und Untergang, (4) Zutritt, Zugang, (5) Auszackung, (6) Schwierigkeiten, Unannehmlichkeiten, ein‑ und ausgehen
虹 (にじ): Regenbogen
葬式 (そうしき): Beerdigung, Bestattung, Begräbnisfeier, Trauerfeier
規律 (きりつ): (1) Regel, Vorschrift, Gebot, Bestimmung, Satzung, (2) Ordnung, Recht und Ordnung, Disziplin, Zucht, (3) Kontrolle, Regulierung, Einschränkung
罹る (かかる): (1) krank werden, eine Krankheit bekommen, leiden an, (2) betroffen werden, geraten in …, erleiden
素質 (そしつ): (1) Anlage, Begabung, Natur, Naturell, (2) Disposition, Konstitution, (3) Tendenz
クリーニング: chemische Reinigung
殴る (なぐる): (1) schlagen, prügeln, verprügeln, verhauen, Schläge versetzen, wichsen, (2) Pfusch, Pfuscharbeit, zusammengeschusterte Arbeit
畳む (たたむ): (1) falten, zusammenfalten, zusammenklappen, (2) abschließen, schließen, auflösen, (3) aufräumen, (4) im Herzen bewahren, (5) kaltmachen, fertig machen, alle machen
逆さ (さかさ): (1) Umkehrung, Inversion, Reversion, Spiegelung, (2) Verkehrung, Wandlung ins Gegenteil, (3) Sterben der Kinder vor den Eltern, verkehrt herum, umgedreht, auf dem Kopf, umgekehrt, verkehrt, verkehrt herum, auf dem Kopf, invertiert
体制 (たいせい): System, Verfassung, Organisation, Struktur
日帰り (ひがえり): Tagesausflug, Zurückkommen am selben Tag, eine Tagesreise machen
頭 (とう): Stück (Zählwort für große Tiere wie Rinder und Pferde)
電流 (でんりゅう): elektrischer Strom
座敷 (ざしき): (1) mit Tatami ausgelegtes Zimmer, Zimmer im japanischen Stil, (2) Stube, Empfangszimmer, Gästezimmer, (3) Zimmer für die Bewirtung von Gästen
学会 (がっかい): (1) wissenschaftliche Gesellschaft, Akademie, (2) Kongress, wissenschaftliche Tagung, wissenschaftliche Versammlung
エプロン: (1) Schürze, (2) Flughafenvorfeld
森林 (しんりん): Wald, Forst
余る (あまる): (1) übrig bleiben, übrig sein, (2) überschreiten, zu viel sein, übermäßig sein
日時 (にちじ): (1) Datum und Zeit, Termin, Datum, Zeit, (2) Tage und Stunden, Zeit
歌留多 (かるた): Spielkarten (werden häufig zu Neujahr gespielt)
幼稚 (ようち): (1) Kindlichkeit, (2) Unreife, (3) Primitivität, (1) kindlich, (2) infantil, kindisch, unreif, noch unentwickelt, (3) primitiv, einfach
文芸 (ぶんげい): Literatur, schöne Literatur, Dichtung, Kunst und Literatur
折角 (せっかく): (1) lang erwartet, (2) freundlich, gefällig, liebenswürdig, nett, (3) extra, speziell, vor allem, vor allen Dingen, (4) unter Anspannung aller Kräfte
筆者 (ひっしゃ): Schreiber, Verfasser, Autor
捩る (ねじる): (1) drehen, verdrehen, schrauben, (2) aufdrehen, zudrehen (z.B. einen Wasserhahn), parodieren, ein Wortspiel machen, drehen, verdrehen
初歩 (しょほ): (1) die ersten Schritte, unterste Stufe, Anfang, Anfangsgründe, (2) Anfänger…, Elementar…, Anfänger…, Elementar…
調節 (ちょうせつ): Regulierung, Einstellung, Anpassung, Kontrollieren, Überwachung, regulieren (z.B. Temperatur), anpassen, kontrollieren
溶ける (とける): schmelzen, sich lösen, sich auflösen
交通機関 (こうつうきかん): Transportmittel, Verkehrsmittel, Kommunikationsmittel
蒸す (むす): (1) dämpfen, dünsten, (2) schwül sein
ダイアグラム: (1) Diagramm, Schaubild, (2) Fahrplan
洗剤 (せんざい): Waschmittel, Waschpulver, Spülmittel, Putzmittel
酌む (くむ): (1) einschenken, (2) trinken
流 (りゅう): (1) Strömung, Stil, Weise, Art, (2) Schule, (3) Klasse, Rang
取り出す (とりだす): (1) entnehmen, herausnehmen, herausziehen, (2) auswerfen, (3) heraussuchen, aussortieren, (4) extrahieren
武士 (ぶし): Recke, Krieger, Samurai, Samurai, Krieger, Ritter, Soldat, Krieger, Soldat, Samurai
為替 (かわせ): (1) Geldanweisung, Wechsel, (2) Devisen
短編 (たんぺん): kleines Stück, kurzer Film, kurze Geschichte, kurzer Text
慰める (なぐさめる): (1) trösten, Trost spenden, aufmuntern, aufheitern, (2) besänftigen, ablenken, unterhalten
符号 (ふごう): Zeichen, Marke, Chiffre, Symbol, Bezugszeichen
引き返す (ひきかえす): umkehren, kehrtmachen, zurückgehen, zurückfahren, zurückkommen
保健 (ほけん): Gesundheitspflege, Hygiene
絨毯 (じゅうたん): Teppich, Läufer
何分 (なにぶん): (1) auf jeden Fall, (2) schließlich, wie Sie wissen, (3) bitte
日本式 (にほんしき): japanischer Stil
実 (み): (1) Frucht, Beere, Nuss, Korn, (2) Inhalt, Gehalt, Substanz, (3) Ergebnis, Frucht einer Arbeit, (4) Suppeneinlage
裁縫 (さいほう): Nähen, Näharbeit, Schneidern
都心 (としん): Stadtzentrum, Zentrum, Stadtkern, Innenstadt (z.B. von Tōkyō)
済まない (すまない): (1) Entschuldigung!, Danke!, (2) bedauern, ein schlechtes Gewissen haben
ダブル: Doppel, Doppel…, doppelt
臨時 (りんじ): (1) Sonder…, Extra…, Aushilfs…, Behelfs…, Not…, (2) außerordentlich, außergewöhnlich, besonders, (3) vorläufig, provisorisch, einstweilig, temporär, Behelfs…, Not…, besonders, provisorisch, zeitweise, (1) außerordentlich, außergewöhnlich, besonders, (2) vorläufig, provisorisch, einstweilig, temporär
面積 (めんせき): Fläche, Flächeninhalt
四角 (しかく): (1) Viereck, (2) Formalität, Steifheit, viereckig
童謡 (どうよう): Kinderlied
テンポ: Geschwindigkeit (insbes. eines Musikstückes), Tempo
輸送 (ゆそう): Beförderung, Transport, transportieren
電波 (でんぱ): Radiowelle
弱点 (じゃくてん): (1) Schwäche, (2) schwacher Punkt
浮かべる (うかべる): (1) schwimmen lassen, treiben lassen, (2) zeigen, (3) sich erinnern, sich vorstellen
バイバイ: (1) Tschüss!, (2) Tschüs!, (3) Wiedersehen!
ぴかぴか: (1) (2) , glitzernd, glänzend, funkelnd
釘 (くぎ): Nagel
整備 (せいび): (1) Vorbereitung, Instandsetzung, Ordnung, Anordnung, Versorgung, (2) Wartung, Kontrolle, Erhaltung, Inspektion, Wartungsdienst, (1) in Ordnung bringen, ordnen, herrichten, instand setzen, vorbereiten, ausrüsten, (2) warten (z.B. Auto od. Flugzeug), kontrollieren, inspizieren, (3) ausstatten, ausrüsten
放る (ほうる): (1) werfen, (2) verzichten auf, (3) seinen Lauf lassen, sich nicht um etw. kümmern
遡る (さかのぼる): (1) gegen den Strom fahren, flussaufwärts gehen, im Fluss hinaufwaten, (2) etw. zurückverfolgen, zurückgehen
画 (が): Bild, Zeichnung
楽器 (がっき): Musikinstrument
直通 (ちょくつう): direkte Verbindung, durchgehender Verkehr, direkt durchgehen, direkt durchfahren, direkt, durchgehend
大学院 (だいがくいん): Graduiertenabteilung (Magister‑ und Doktorkurse an der Universität)
うんと: viel, tüchtig, mit großer Kraft, massig, ungemein
課程 (かてい): Kursus, Lehrgang, Lehrplan, Curriculum, Studium
飾り (かざり): Schmuck, Dekoration
盆 (ぼん): Bon-Fest, buddhistisches Totengedenken (um den 15. August; fallender Tonakzentunterscheidet sich dadurch vom Homograph mit der Bedeutung Tablett), Tablett (Tonakzent unterscheidet sich vom Homograph mit der Bedeutung Bon-Fest)
地質 (ちしつ): (1) Bodennatur, Bau der Erde, Geologie, (2) Bodenbeschaffenheit
解散 (かいさん): (1) Auflösung, Beendigung, Zerstreuung (einer Versammlung, einer Party, einer Demonstration), (2) Auflösung (einer Organisation, einer Firma, von Truppen), (3) Auflösung des Parlaments, beenden, aufbrechen, auseinandergehen, auflösen, sich zerstreuen
はきはき: klar, deutlich, klipp und klar, aufgeweckt
行き成り (いきなり): (1) (2) 
何とも (なんとも): (1) wirklich, ziemlich, sehr, (2) nichts
関西 (かんさい): Kansai (Gebiet um Kyōto und Ōsaka)
原料 (げんりょう): Rohmaterial, Rohstoff
甚だしい (はなはだしい): höchst, äußerst, außerordentlich, ungemein, ungewöhnlich
水曜 (すいよう): Mittwoch
拭く (ふく): wischen, abwischen, wegwischen, auswischen
転がる (ころがる): (1) sich herumdrehen, sich herumwälzen, rollen, (2) herunterfallen, hinfallen, fallen, herunterstürzen, (3) sich hinlegen, sich zur Ruhe legen
斯うして (こうして): so, auf diese Weise, wie dies, wie folgt
勘違い (かんちがい): Missverständnis, Irrtum, Verwechselung, missverstehen, sich irren, verwechseln
法則 (ほうそく): Gesetz, Naturgesetz, Regel
冷やす (ひやす): (1) kühlen, kaltstellen, abkühlen, (2) ruhig werden, (3) sich fürchten
爽やか (さわやか): (1) frisch, erquickend, auffrischend, (2) klar, klangvoll, (3) klar und fließend, beredt, redegewandt
小母さん (おばさん): (1) Tante, (2) Madam, Frau mittleren Alters
楕円 (だえん): Ellipse, elliptische Form, Oval, elliptisch
売れ行き (うれゆき): Absatz, Umsatz, Nachfrage, Verkauf, Bedarf
転々 (てんてん): (1) von einem Ort zum anderen, von Hand zu Hand, (2) rollend, (1) von Hand zu Hand gehen, (2) rollen, herumwandern
扇ぐ (あおぐ): (1) fächeln, (2) anfachen, (3) worfeln, Körner von der Spreu trennen
レベル: Level, Niveau
休養 (きゅうよう): Erholung, sich erholen, ausspannen, sich entspannen, ruhen, sich ausruhen, Ferien machen, sich erfrischen
次ぐ (つぐ): als Nächstes kommen, an nächster Stelle stehen, nach etw. rangieren
性質 (せいしつ): (1) Natur, Naturell, Gemütsart, Temperament, (2) Charakter, Eigenschaft, Benehmen, Qualität
払い戻す (はらいもどす): (1) zurückzahlen, (2) rückzahlen, auszahlen
寝台 (しんだい): Bett
コレクション: (1) Sammlung, (2) Collection, Mode-Collection
更ける (ふける): (1) spät werden, auf Mitternacht zugehen, (2) in der Jahreszeit spät werden, (3) in der Brunst sein
胡椒 (こしょう): (1) Pfeffer, Piper nigrum, (2) Gartenkresse, Lepidium sativum
怪しい (あやしい): (1) verdächtig, dubios, zweifelhaft, fragwürdig, merkwürdig, befremdlich, bedenklich, seltsam, sonderbar, mysteriös, wunderlich, ominös, (2) unzuverlässig, unglaubwürdig, unsicher, schlecht
ミシン: Nähmaschine, Maschine
気圧 (きあつ): (1) Gasdruck, (2) Luftdruck, Atmosphärendruck, (3) physikalische Atmosphäre (alte Maßeinheit des Luftdruckes; Zeichen: atm)
単数 (たんすう): Einzahl, Singular, singularisch
申し訳ない (もうしわけない): Es tut mir sehr leid!
組み立てる (くみたてる): zusammensetzen, zusammenbasteln, montieren, bauen, aufstellen
目指す (めざす): (1) auf etw. zugehen, nach … streben, (2) erstreben, zum Ziel haben, zielen auf, streben nach, beabsichtigen
関東 (かんとう): (1) Kantō (Gebiet um Tōkyōdie Präf. Tōkyō, Ibaraki, Tochigi, Gunma, Saitama, Chiba und Kanagawa bzw. allg. das Gebiet östlich von Hakone), (2) Kantō (die früheren Prov. Suzuka, Fuwa und Arachi; Gebiet östlich der Grenzstation von Ōsaka, Shiga-ken; nach dem Ritsuryō-System), (3) Kamakura-Bakufu, (4) Kantō-Regionalverwaltung, (5) Edo-Bakufu, (6) Guangdong, Kwantung (Prov. in Südost-China, am Südchinesischen Meer; früher Provinz der Mandschurei)
喧しい (やかましい): (1) laut, lärmend, geräuschvoll, (2) streng, genau, krittelig, (3) wählerisch, (4) viel diskutiert, in aller Munde
存ずる (ぞんずる): wissen, sich etw. bewusst sein, denken
書留 (かきとめ): Einschreiben (Abk.)
公害 (こうがい): Umweltverschmutzung, Umweltzerstörung
酸性 (さんせい): Acidität, Säuregrad od. Säuregehalt einer Flüssigkeit, sauer
申請 (しんせい): Gesuch, Bitte, Antrag, Ansuchen, ansuchen, bitten
被せる (かぶせる): (1) bedecken, zudecken, abdecken, ablegen, ausbreiten, verhüllen, umhüllen, (2) beschuldigen, seine Schuld abwälzen
物騒 (ぶっそう): Unsicherheit, Gefährlichkeit, Unheimlichkeit, gefährlich, unsicher, unruhig, verdächtig, unheimlich
引き算 (ひきざん): Subtraktion
ご苦労さま (ごくろうさま): (1) Vielen Dank für Ihre Bemühungen!, (2) Vielen Dank für Ihre Mühe! (Ausdruck des Dankes gegenüber einer Person, die gerade etw. für den Sprecher tut bzw. getan hat)
改める (あらためる): (1) neu machen, beginnen, (2) erneuern, renovieren, verbessern, reformieren, revidieren, korrigieren, ändern, (3) förmlich werden lassen, eine förmliche Haltung einnehmen lassen, (4) untersuchen, prüfen, besichtigen, (5) jmdn. ersetzen, jmdn. anderen einsetzen
地面 (じめん): (1) Erdoberfläche, Erde, Boden, (2) Grund, Grundstück
活力 (かつりょく): Lebenskraft, Vitalität, Lebensdrang, Lebensenergie, Lebenstrieb
片道 (かたみち): Hinweg, ein Weg, einfache Fahrt, Hinfahrt
ダイヤモンド: Diamant
矛盾 (むじゅん): Widerspruch, Unvereinbarkeit, Unverträglichkeit, Diskrepanz, sich widersprechen, im Widerspruch stehen, unvereinbar sein
鋸 (のこぎり): Säge
丼 (どんぶり): (1) Schüssel, (2) Donburi (Schüssel Reis mit Beilage darauf), (3) große Vordertasche bei Arbeitswesten
氏名 (しめい): Vor‑ und Zuname, Familienname und Vorname
学年 (がくねん): Schuljahr, Studienjahr, akademisches Jahr,  …te Klasse
定価 (ていか): Listenpreis, fester Preis
ぶら下げる (ぶらさげる): (1) hängen, herunterhängen lassen, (2) tragen, (3) sehen lassen, (4) nachlaufen
複数 (ふくすう): (1) Vielzahl, (2) Plural, Mehrzahl, mehrere
祝日 (しゅくじつ): Festtag, Feiertag,  (insbes.) nationaler Feiertag
発売 (はつばい): Verkauf, auf den Markt bringen, verkaufen, absetzen
領収 (りょうしゅう): Empfang, Empfangen, Erhalt, empfangen, erhalten, beziehen, bekommen
恩恵 (おんけい): (1) Gnade, Segen, Wohltat, Mitleid, Mitgefühl, Sympathie, (2) göttliche Gnade, Barmherzigkeit
破く (やぶく): zerreißen
使い (つかい): (1) Bote, Botengänger, Laufbursche, (2) Botengang, Besorgung, (3) Götterbote, (4) Tierbändiger
献立 (こんだて): (1) Speisenfolge, (2) Speisekarte, Menü, (3) Inhalt und Details einer Sache, (4) Programm, Abfolge, (5) Aufbau
売買 (ばいばい): Kauf und Verkauf, Einkauf und Verkauf, Handel, Geschäft, Umsatz, kaufen und verkaufen, handeln
零す (こぼす): (1) verschütten, vergießen, umstürzen, umwerfen, (2) (Tränen) vergießen, (3) klagen, murren, brummen, nörgeln, schmollen
基準 (きじゅん): Standard, Richtlinie, Norm, Maßstab, Basis, Grundlage, Grund, Standard…, (1) Kriterium, Richtmaß, Norm, (2) Kriterium (engl. criterion)
キャンパス: (1) Campus, Universitätsgelände, (2) Universität
惨め (みじめ): Elend, Misere, Armseligkeit, elend, armselig, miserabel, bedauernswert, unglücklich, erbärmlich
お目出度い (おめでたい): (1) erfreulich, glücklich, glückverheißend, zu beglückwünschen, (2) naiv, arglos, leicht zu betrügen, gutmütig, dumm
店屋 (みせや): Geschäft, Laden
花嫁 (はなよめ): Braut, frisch vermählte Frau
見舞う (みまう): (1) besuchen, Besuch abstatten, sich erkundigen, (2) überfallen, heimsuchen, schlagen
お辞儀 (おじぎ): Verbeugung, Verneigung, Kompliment, Gruß, sich verneigen, sich verbeugen, eine Verbeugung machen
回り道 (まわりみち): Umweg, Abstecher
快晴 (かいせい): heiteres Wetter, schönes Wetter, klares Wetter, wolkenfreier Himmel, Bewölkungsgrad 0–1, heiter, wolkenlos, schön
車庫 (しゃこ): Garage, Einstellplatz, Wagenschuppen, Depot (für Omnibusse und Schienenfahrzeuge)
汁 (しる): Suppe, Brühe, Saft, Soße, Tsuyu, (1) Saft, (2) Suppe, Brühe
改札 (かいさつ): Fahrkartenkontrolle, Fahrkarten kontrollieren, Fahrkarten lochen, entwerten
重ねる (かさねる): (1) aufeinanderlegen, übereinander legen, stapeln, aufhäufen, aufschichten, aufstapeln, auftürmen, (2) wiederholen, repetieren
書店 (しょてん): Buchhandlung, Buchladen, Verlag
水産 (すいさん): (1) Fischerei, (2) Meeresprodukte, Wasserprodukte
確率 (かくりつ): Wahrscheinlichkeit
面接 (めんせつ): Vorstellungsgespräch, Unterredung, Zusammentreffen, Gespräch, Interview, Unterredung (zur Prüfung von Fähigkeiten, Persönlichkeit etc.), sich unterreden, mündlich prüfen
便箋 (びんせん): Briefpapier
和英 (わえい): (1) Japanisch und Englisch, (2) japanisch-englisches Wörterbuch (Abk.)
自ら (みずから): selbst, selber, persönlich, in eigener Person, eigenhändig, direkt
厚かましい (あつかましい): frech, schamlos, unverschämt, aufdringlich
大凡 (おおよそ): (1) etwa, ungefähr, zirka, annähernd, (2) ganz, überhaupt, ganz und gar, im Großen und Ganzen
感激 (かんげき): tiefe Bewegung, tiefe Rührung, Ergriffenheit, Erschütterung, Begeisterung, Inspiration, Leidenschaft, gerührt sein, tief beeindruckt sein, sich begeistern
捕る (とる): fangen, fassen, ergreifen
防止 (ぼうし): Vorbeugung, Verhütung, Verhinderung, Bekämpfung, abhalten, aufhalten, hemmen, hindern, verhindern, verhüten, etw. zuvorkommen, etwas Einhalt gebieten
逆さま (さかさま): (1) Umkehrung, Inversion, Reversion, Spiegelung, (2) Verkehrung, Wandlung ins Gegenteil, (3) Sterben der Kinder vor den Eltern, umgekehrt, umgekehrt, mit dem Kopf nach unten
電球 (でんきゅう): Glühlampe, Glühbirne
民謡 (みんよう): Volkslied
税関 (ぜいかん): Zollamt, Zoll
詫びる (わびる): sich entschuldigen, jmdm. Abbitte tun, jmdn. um Verzeihung bitten
形容動詞 (けいようどうし): adjektivisches Nomen, Quasi-Adjektiv, na-Adjektiv
便所 (べんじょ): Abort, Toilette
本部 (ほんぶ): Hauptverwaltung, Hauptbüro, Zentrale, Sitz, Hauptquartier
点数 (てんすう): (1) Punkte, Zensur, (2) Anzahl der Waren, Sortiment
危うい (あやうい): (1) gefährlich, gefahrvoll, abenteuerlich, (2) sorgenvoll, sorgenschwer, (3) bange sein, Angst haben
空中 (くうちゅう): Luft, Himmel
怠る (おこたる): vernachlässigen, nachlässig sein, faul sein, versäumen, sich nicht kümmern
登場 (とうじょう): Bühnenauftritt, Auftritt, auftreten
仮定 (かてい): (1) Annahme, Hypothese, Voraussetzung, (2) Postulat, (3) Hypothese, annehmen, voraussetzen, eine Hypothese aufstellen
蕩蕩 (とうとう): (1) riesig, weit, (2) ruhig, still
先先週 (せんせんしゅう): vorletzte Woche
属する (ぞくする): (1) dazugehören, zugehören, angehören, (2) unter (eine Kategorie etc.) fallen, (3) … ist Element von … (Symbol: ∈)
可決 (かけつ): Verabschiedung (einer Gesetzesvorlage), Billigung, Annahme, bewilligen, annehmen, verabschieden
奴 (やつ): (1) Kerl, Bursche, Prachtkerl, (2) Ding, Sache, Teil
社説 (しゃせつ): Leitartikel
日の出 (ひので): (1) Sonnenaufgang, (2) Kraft, Hinode (Stadt im Westen der Präf. Tōkyō)
脱線 (だっせん): (1) Entgleisung, (2) Abschweifung, (1) entgleisen, (2) abkommen, abschweifen
揶揄う (からかう): necken, foppen, ärgern, aufziehen, hänseln
総理大臣 (そうりだいじん): Ministerpräsident, Premierminister
欠伸 (あくび): Gähnen
小遣い (こづかい): Taschengeld
ダブる: (1) sich überlappen, doppelt sein, sich überlagern, (2) durchfallen (bei einer Prüfung), (3) ein Double-Play begehen, (4) einen Doppelfehler machen
性能 (せいのう): (1) Leistungsfähigkeit, Leistung, Wirkungsgrad, Nutzeffekt, (2) Beschaffenheit
耕地 (こうち): Land, Ackerland, Ackerboden, Kulturland, bebautes Land
騙す (だます): (1) betrügen, täuschen, anführen, beschwindeln, hinters Licht führen, (2) fremd gehen, (3) jmdn. überreden, jmdm. etw. einreden, jmdm. gut zureden
生ずる (しょうずる): (1) erzeugen, hervorbringen, hervorrufen, verursachen, (2) entstehen, geschehen
溶く (とく): auflösen, lösen, schmelzen
或 (ある): ein, ein gewisser
空っぽ (からっぽ): Leerheit, Hohlheit, leer, hohl
知り合い (しりあい): Bekannter, Bekannte, Bekanntschaft
テニスコート: Tennisplatz
草履 (ぞうり): Strohsandalen, Zōri
独りでに (ひとりでに): von alleine, von alleine, automatisch, selbständig
歯磨き (はみがき): (1) Zahnpasta, Zahncreme, (2) Zähneputzen
一流 (いちりゅう): eine Fahne, ein Banner, (1) erster Rang, erste Klasse, (2) eine Kunstrichtung, eine Schule, (3) eigener Stil, charakteristischer Stil, (1) erstrangig, erstklassig, führend, leitend, ersten Ranges, Haupt…, (2) charakteristisch, eigentümlich
斜 (はす): Schrägheit, Schräge, Neigung
お八つ (おやつ): Nachmittagskaffee, Vesper, Zwischenmahlzeit am Nachmittag
純情 (じゅんじょう): Naivität, Unschuld, Treuherzigkeit, naiv, unschuldig, treuherzig
紙幣 (しへい): Geldschein, Papiergeld, Banknote
手続き (てつづき): (1) Verfahren, Prozedur, Formalität, Ablauf, Verfahrensschritt, (2) Unterprogramm, Subroutine
ボーナス: Bonus, Gratifikation, 13. bzw. 14. Gehalt, Urlaubsgeld, Weihnachtsgeld
萎む (しぼむ): welken, verwelken
皮肉 (ひにく): Ironie, Spott, Sarkasmus, Satire (den Zeichen nach: Haut und Fleisch), ironisch, sarkastisch
ブローチ: Brosche, Räumahle, Räumnadel, Räumwerkzeug
例える (たとえる): (1) vergleichen, (2) eine Metapher benutzen, in Bildern sprechen
裏口 (うらぐち): Hintertür (übertr.)Hintertreppe
恨む (うらむ): (1) übel nehmen, ärgerlich sein, böse sein, jmdm. grollen, jmdm. etw. nachtragen, einen Groll hegen, beschuldigen, vorwerfen, (2) bedauern, leider so sein
要旨 (ようし): das Wesentliche, Kern, Hauptinhalt, Hauptsache, Zusammenfassung
えっと: nun, ja, also, äh! (zur Überbrückung einer Sprechpause, weil man nach dem richtigen Wort sucht oder weil man zögert etw. zu sagen)
縮める (ちぢめる): (1) kürzen, verkürzen, kürzer machen, (2) enger machen, (3) zusammenziehen, einziehen
百科事典 (ひゃっかじてん): Enzyklopädie, Lexikon
歩 (ほ): (1) Schritt, (2) Fortschritt, Fortgang
夜間 (やかん): Nacht, nachts, in der Nacht, bei Nacht, nachts
交流 (こうりゅう): (1) Wechselstrom, (2) Austausch
月日 (つきひ): Zeit, Tage, Tage und Monate
苦情 (くじょう): (1) Beschwerde, Einwand, Beanstandung, Klage, Einspruch, (2) Verwicklung, Schwierigkeit, Komplikation
雑音 (ざつおん): (1) Geräusch, Nebengeräusch, Störgeräusch, (2) Beeinflussung von außen, Einmischung von außen
澄む (すむ): klar werden, sich aufklären, sich aufhellen
嚏 (くしゃみ): Niesen, Sternutation
工事 (こうじ): Bau, Bauarbeit, Arbeit, bauen
客間 (きゃくま): (1) Salon, gute Stube, Empfangszimmer, (2) Gästezimmer
膨らます (ふくらます): aufblasen, ausbeulen, aufblähen, anschwellen, ausbauchen, aufquellen
遍 (へん): Mal
泊める (とめる): (1) jmdn. beherbergen, jmdn. bei sich übernachten lassen, unterbringen, (2) Anker werfen, ankern lassen
下駄 (げた): (1) Geta, japanische Holzsandale, Stelzenschuhe, (2) Fliegenkopf (auf den Kopf gestellte Bleiletter; in Japan z.B. als Blockade für ein Zeichen, für das der Drucker keine Letter hat; wird als zwei waagrechte Rechtecke gedruckt; erinnert an die zwei Stelzen von Geta)
× (ばつ): Kreuz, X, Markierung für falsch od. ungenügend, (1) Misserfolg, Schlag ins Wasser, (2) Kreuz-Zeichen für einen Fehler
飛び込む (とびこむ): (1) hineinspringen, sich hineinwerfen, (2) hineinstürzen, hineinstürmen, (3) sich in etw. stürzen, sich einer Sache ganz hingeben, (4) etw. stürzt auf einen ein, man wird von etw. heimgesucht
非 (ひ): (1) Fehler, (2) das Böse, das Falsche, (3) Nachteil, ungünstige Kritik, (4) un…, anti…, nicht…
題名 (だいめい): Titel (eines Buches od. Kunstwerkes etc.)
直径 (ちょっけい): Durchmesser, (mn) Diameter
釣り合う (つりあう): (1) ausbalancieren, ins Gleichgewicht bringen, (2) harmonisieren, in Harmonie sein, passen, (3) passend sein, gut passen
瀬戸物 (せともの): Porzellan, Steingut, Keramik, Töpferware, Tonware
ドキドキ: (1) klopf-klopf, poch-poch, (2) Pochen, Klopfen (des Herzens; wegen Bewegung; aus Furcht, aus Überraschung, aus Erwartung etc.), klopfen, pochen, schlagen
英文 (えいぶん): (1) Englisch, auf Englisch Geschriebenes, englischer Satz, englischer Aufsatz, (2) Anglistik, Fakultät für Anglistik (Abk.)
弟子 (でし): Schüler, Jünger, Anhänger, Lehrling, Schüler, Jünger
謎々 (なぞなぞ): Rätsel
吐き気 (はきけ): Brechreiz, Übelkeit, Ekel
突っ込む (つっこむ): (1) in etw. stecken, in etw. stopfen, (2) sich in etw. stürzen, (3) nachfragen
論ずる (ろんずる): argumentieren, einen Beweis führen, diskutieren, erörtern, debattieren, disputieren
一応 (いちおう): (1) (2) 
送り仮名 (おくりがな): Okurigana (Kana, die an ein Kanji angefügt werden, um die Flexion anzuzeigen)
崩れる (くずれる): (1) zusammenbrechen, zusammenfallen, zusammenstürzen, zerfallen, (2) zerdrückt werden,  (seine) Form verlieren, (3) Geld wechseln können
王女 (おうじょ):  (königliche)Prinzessin, Königstochter
増大 (ぞうだい): Vermehrung, Zunahme, zunehmen, vermehren
躊躇う (ためらう): (1) zögern, zaudern, (2) schwanken, unschlüssig sein
プログラム: (1) Programm, (2) Computerprogramm, Programm
生る (なる):  (Früchte) tragen, Erfolg haben
人文科学 (じんぶんかがく): Geisteswissenschaften, Kulturwissenschaften
日陰 (ひかげ): (1) Sonnenlicht, (2) Schatten, Schatten
重点 (じゅうてん): Schwerpunkt, Bedeutung, Gewicht, Wert
交代 (こうたい): Ablösung, Abwechselung, Wechsel, Schicht, Schichtwechsel, sich ablösen, sich abwechseln, an jmds. Stelle treten, die Plätze wechseln, jmds. Platz übernehmen
手首 (てくび): Handgelenk
齧る (かじる): (1) knabbern, nagen, kauen, beißen, (2) nur ein bisschen wissen, oberflächliche Kenntnisse haben
行方 (ゆくえ): (1) Ziel, Aufenthalt, Aufenthaltsort, Verbleib, (2) Zukunft, Aussicht
醜い (みにくい): (1) hässlich, unschön, (2) niederträchtig, schändlich, unehrenhaft
気体 (きたい): Gas, Materie im gasförmigen Aggregatzustand
流石 (さすが): (1) auch, selbst, sogar, einfach, (2) indessen, jedoch, (3) wie zu erwarten, natürlich
体重 (たいじゅう): Körpergewicht
怒鳴る (どなる): (1) schreien, brüllen, donnern, bellen, (2) anschnauzen, anfahren, ausschelten, ausschimpfen, (3) anschreien, anbrüllen
扇風機 (せんぷうき): Ventilator
傑作 (けっさく): (1) Meisterstück, Meisterwerk, herausragendes Werk, (2) schwerer Fehler, grober Schnitzer, grober Ausrutscher
紙屑 (かみくず): Papierabfälle, Papierschnitzel
拡張 (かくちょう): Ausweitung, Erweiterung, Vergrößerung, Ausdehnung, Verstärkung, erweitern, ausdehnen, vergrößern, ausweiten, verstärken
仕方がない (しかたがない): (1) nicht zu ändern, unvermeidbar, (2) Da kann man nichts machen!, (3) unverbesserlich, unerträglich, unmöglich, (4) unbedingt, (5) gezwungenermaßen
くっ付ける (くっつける): (1) ankleben, etw. aneinander befestigen, (2) auf die eigene Seite ziehen, zum Verbündeten machen, (3) zusammenbringen, verkuppeln (einen Mann und eine Frau)
高層 (こうそう): (1) hohes Aufragen, große Höhe, Vielstöckigkeit, (2) hohe Luftschicht, hoch, hoch aufragend
足元 (あしもと): (1) unter den Füßen, zu Füßen, (2) Sie, Ihr, du (gegenüber jmdm. verwendet, dem man ebenbürtig ist), (1) Platz für die Füße, Platz für die Schritte, Platz zu Füßen, (2) Nähe, Nahes, Schritt, Gang, (3) Schwäche, zu Füßen, vor den Füßen, unter den Füßen
基礎 (きそ): (1) Fundament, Grundmauer, Unterbau (eines Gebäudes), (2) Grundlage, Basis, Grund, Fundament, (3) Fundamentarbeiten
見上げる (みあげる): (1) hinaufblicken, nach oben sehen, (2) bewundern, auf sehen zu …
空想 (くうそう): (1) Träumerei, Traumbild, Fantasie, Einbildung, Vision, Hirngespinst, Luftschloss, (2) in der Lehre von der Leere gefangenes Denken, fantasieren, sich ausmalen, sich einbilden, sich vorstellen, träumen, Luftschlösser bauen
分量 (ぶんりょう): Quantität, Menge, Dosis
職場 (しょくば): Arbeitsplatz, Dienststelle
乾杯 (かんぱい): (1) Leeren des Trinkbechers, (2) Anstoßen (auf ein freudiges Ereignis od. die Gesundheit), Trinken (auf etw.), (3) Prosit, Prost, anstoßen, einen Trinkspruch ausbringen
真っ白 (まっしろ): Schneeweiß, reines Weiß, Schlohweiß, Unbeflecktheit, schneeweiß, ganz weiß, schlohweiß, unbefleckt
英和 (えいわ): England und Japan
直角 (ちょっかく): rechter Winkel, rechtwinklig
宴会 (えんかい): Festmahl, Bankett, Festessen, Dinner, Fest, Party
姓 (せい): Familienname
目出度い (めでたい): (1) glücklich, glückverheißend, zu beglückwünschen, (2) naiv, arglos, dumm
地味 (じみ): (1) Einfachheit, Schlichtheit, Anspruchslosigkeit, Bescheidenheit, Zurückhaltung, Verschlossenheit, (2) Bodenbeschaffenheit, Bodenfruchtbarkeit, schlicht, unauffällig, anspruchslos, einfach, seriös, brav, dezent, bescheiden, still, verschlossen, zurückhaltend
原始 (げんし): Anfang, Uranfang, Primitivität, Genesis, primitiv
サイレン: Sirene
ずれる: (1) sich verschieben, verrutschen, (2) sich neigen, (3) abweichen, (4) danebenliegen, nicht zur Sache gehören, fehl am Platze sein
見学 (けんがく): Besichtigung, Studienreise, Kengaku, zu Studienzwecken besichtigen, eine Studienreise machen
迷信 (めいしん): Aberglaube
中身 (なかみ): (1) das Innere, (2) Inhalt, Gehalt, Substanz, Füllung, (3) Klinge
索引 (さくいん): Index, Register, Sachverzeichnis, Verzeichnis
学科 (がっか): (1) Fach, Fachbereich, Unterrichtsgegenstand, Wissensgebiet, (2) Lehrgang, Kurs, (3) Theorie (im Ggs. zur Praxis)
実用 (じつよう): praktischer Gebrauch, praktischer Nutzen, praktische Anwendung, Verwendung
扇子 (せんす): Fächer, Faltfächer
匙 (さじ): (1) Löffel, (2) Arzt
締め切り (しめきり): (1) Geschlossensein, Verschlossensein, (2) Schluss, letzter Termin, Abschlusstermin, Redaktionsschluss, Anmeldeschluss, Abgabeende, Einsendeschluss, Deadline
解答 (かいとう): Lösung, Auflösung, Antwort, lösen, auflösen, antworten
丁目 (ちょうめ): Häuserblock, Block
偉い (えらい): (1) angesehen, bedeutend, groß, einflussreich, hervorragend, berühmt, außerordentlich, einzigartig, überragend, vortrefflich, (2) schlimm, ernst, schrecklich, hart, (3) unglaublich, erstaunlich, überraschend, (4) schmerzlich, hart, unangenehm
賞品 (しょうひん): Preis
改造 (かいぞう): Umbildung, Umgestaltung, Reformierung, Reorganisation, Neugestaltung, Umbau, Neubildung, Wiederaufbau, umbilden, neu gestalten, neu bilden, umbauen, umformen, umgestalten
終点 (しゅうてん): (1) Endstation, Endbahnhof, Endpunkt, (2) Endpunkt (einer Strecke, eines Vektors)
すれ違う (すれちがう): (1) sich treffen, aneinander vorbeigehen, (2) sich verpassen, aneinander vorbeigehen, aneinander vorbeifahren, (3) aneinander vorbeireden
尖る (とがる): (1) spitz werden, sich verjüngen, (2) spitz sein, (3) schrill sein, scharf sein (Stimme), (4) sauer sein, verärgert sein
炭鉱 (たんこう): (1) Schacht, aus dem Kohle gefördert wird, (2) Kohlenbergwerk, Bergwerk, Kohlengrube, Kohlenbergwerk, Kohlengrube, Kohlenzeche
副 (ふく): Duplikat
逸れる (それる): abweichen, abschweifen, fehlgehen, abirren
思い込む (おもいこむ): (1) fest glauben, fest rechnen mit …, fest überzeugt sein, von fester Überzeugung sein, festen Glaubens sein, (2) entschlossen sein, (3) sein Herz verlieren, sein Herz hängen an, (4) sich vorstellen, sich einbilden, von einer Illusion eingenommen werden
稀 (まれ): (1) selten, rar, ungewöhnlich, vereinzelt, knapp, spärlich, wenig, (2) beispiellos, epochal, unerhört, ohnegleichen, selten, rar, ungewöhnlich, selten, nur selten einmal, in großen Zwischenräumen
ダム: Damm, Staudamm, Deich
当てはまる (あてはまる): zutreffen, anwendbar sein, brauchbar sein
入れ物 (いれもの): (1) Behälter, Gefäß, Etui, Futteral, (2) Sarg (als Ersatz für das entsprechende Tabuwort verwendet)
美容 (びよう): (1) Schönheit, Kosmetik, (2) Verschönerung
余所 (よそ): (1) anderswo, ein anderer Ort, (2) anderer, Fremder, (3) ohne direkte Beziehung
凭れる (もたれる): (1) sich anlehnen, sich stützen, sich verlassen, (2) schwer im Magen liegen, schwer bekömmlich sein
秤 (はかり): Waage
恋しい (こいしい): (1) lieb, geliebt, teuer, (2) ersehnt, vermisst
力強い (ちからづよい): (1) stark, kräftig, kraftvoll, (2) beruhigend, sicher
凹む (へこむ): (1) eingebeult werden, hohl werden, sich senken, nachgeben, (2) kleinlaut werden, niedergeschlagen werden, (3) Verlust erleiden, zu Schaden kommen
自宅 (じたく): Wohnung, Privatwohnung, eigenes Haus, Eigenheim
書道 (しょどう): Kalligraphie
長引く (ながびく): (1) sich lange hinziehen, sich in die Länge ziehen, kein Ende nehmen wollen, (2) chronisch werden
投書 (とうしょ): (1) Beschwerdebrief, Meinungsbrief, (2) Leserbrief, Leserzuschrift, Beitrag, (1) jmdm. in einem Brief seine Meinung, seine Beschwerde oder seinen Wunsch sagen, (2) einen Leserbrief schreiben
感ずる (かんずる): fühlen, empfinden, wahrnehmen, spüren, merken, ahnen, den Eindruck haben, erkennen
一定 (いってい): (1) Bestimmtheit, Regelmäßigkeit, Standard, (2) Festlegung, bestimmen, entscheiden, festsetzen, standardisieren, vereinheitlichen, bestimmt, gewiss, ausgemacht, feststehend, regelmäßig, beständig, dauerhaft, konstant, normal, musterhaft, vorgeschrieben
群れ (むれ): (1) Herde, Viehherde, Gruppe, Haufen, Menge, Schar, Partei, Zug, Schwarm (z.B. Mücken), Schule (z.B. Wale), (2) Pöbelhaufen, Pöbel, Brut, Bande, Horde, Masse, Meute, Volk
心身 (しんしん): Geist und Körper, Körper und Geist, Leib und Seele
通用 (つうよう): (1) allgemeiner Gebrauch, Gebräuchlichkeit, Verbreitung, Umlauf, (2) Allgemeingültigkeit, Gültigkeit, Akzeptanz, (3) Gültigkeit (eines Tickets), (4) Benutzung als Durchgang, Ein- und Ausgehen, (5) Vermitteln seiner Ansicht, (6) Verständlichmachung einer Bedeutung, (7) Verpfändung, (8) Stuhlgang, (1) in Gebrauch sein, verbreitet sein, in Umlauf sein, (2) allgemein gültig sein, akzeptiert sein, (3) gültig sein, (4) als Durchgang benutzen, ein und aus gehen, (5) sich verständlich machen, verstanden werden
皺 (しわ): Falte, Runzel, Krähenfüße, Furche, Knitter
プリント: (1) Abzug, Kopie, Druck, Hand-out, (2) Drucken, Druck, drucken, bedrucken, Abzüge machen, Kopien machen
休業 (きゅうぎょう): Schließung, Stilllegung (eines Betriebes od. Geschäftes), geschlossen sein, schließen, Feiertag machen, Ruhetag machen
貝 (かい): (1) Muschel, (2) Muschelschale, Schale, (3) Muschelhorn, (4) Kai・awase, Spiel mit Muscheln (der Adligen der Heian-Zeit)
暢気 (のんき): unbekümmert, sorglos, leichtsinnig, sorgenfrei, optimistisch
共産 (きょうさん): gemeinsamer Besitz
墨 (すみ): (1) Tusche, schwarze Tinte, (2) Tuschstein, (3) Tintenfischtinte
ダイヤル: (1) Wählscheibe (eines Telefons), Nummernscheibe, (2) Zifferblatt, Skala, (3) Skalenrad (eines Radios), (4) Wählen, wählen
頭脳 (ずのう): (1) Gehirn, (2) Kopf, Verstand
乗り換え (のりかえ): Umsteigen
勝負 (しょうぶ): (1) Sieg oder Niederlage, (2) Wettkampf, Spiel, Glücksspiel, einen Kampf auskämpfen, einen Streit austragen, um die Wette streiten, wetteifern, sich im Ringen messen
夕立 (ゆうだち): (1) Regenschauer an einem Sommerabend, abendlicher Platzregen, Abendgewitter, (2) Aufkommen von Wind oder Wellen am Abend
上り (のぼり): (1) Anstieg, Aufstieg, Steigung, (2) Zug, der vom Land in die große Stadt fährt
大小 (だいしょう): (1) Großes und Kleines, Größe, (2) Wichtiges und Unwichtiges, (3) die beiden Schwerter, Lang- und Kurzschwert, (4) kleine Trommel und große Trommel, (5) lange und kurze Monate, in allen Größen
引力 (いんりょく): Anziehungskraft, Schwerkraft, Gravitation
通貨 (つうか): Währung, kursierendes Geld, umlaufendes Geld, Kurantgeld, Devise
真っ先 (まっさき): der Erste
雨戸 (あまど): Amado, Holzschiebetür, Fensterladen, Regentür
引っかかる (ひっかかる): (1) hängen bleiben, sich verfangen, sich verhaken, (2) angehalten werden, stecken bleiben, (3) in die Falle gehen, auf den Leim gehen, ins Garn gehen, auf etw. hereinfallen, (4) verwickelt werden, sich verwickeln, (5) ein unbefriedigendes Gefühl zurücklassen, nicht loslassen, (6) beschmutzt werden, begossen werden, bespritzt werden, von etw. getroffen werden
売り上げ (うりあげ): Erlös, Ertrag, Umsatz, Gewinn, Einnahme, Verkauf, Quittung
話し合い (はなしあい): Gespräch, Besprechung, Rücksprache, Unterredung, Verhandlung, Konferenz, Sitzung
見下ろす (みおろす): (1) herabsehen, heruntersehen, (2) von oben herab ansehen, verachten
掃く (はく): (1) fegen, kehren, (2) bepinseln
洋品店 (ようひんてん): Mode‑ und Kurzwarenhandlung
自治 (じち): Selbstverwaltung, Autonomie, Selbständigkeit, Eigengesetzlichkeit
マフラー: (1) Schal, Halstuch, (2) Schalldämpfer
長男 (ちょうなん): ältester Sohn, Erstgeborener
薬局 (やっきょく): Apotheke, Arzneiausgabe
一段 (いちだん): (1) eine Stufe, eine Sprosse, (2) ein Abschnitt, (3) (z.B. Budô) erster Grad, erster Dan, (4) eine Verbstufe (Abk.), (5) noch mehr, (6) einstufig, einfach, primär, um so mehr als …, besonders, insbesondere, noch mehr, ziemlich, beträchtlich
調味料 (ちょうみりょう): Gewürz
農村 (のうそん): Bauerndorf, Dorf, Landgemeinde, ländlich, Agrar…, Land…
相違 (そうい): Unterschied, Verschiedenheit, Ungleichheit, Differenz, Diskrepanz, sich unterscheiden, abweichen, verschieden sein, differieren, nicht übereinstimmen, auseinandergehen
お先に (おさきに): Ich muss leider schon gehen
政党 (せいとう): politische Partei
偶 (たま): gelegentlich, selten, hin und wieder, manchmal, bisweilen (mit no und ni)
乗り越し (のりこし): Zu-weit-Fahren
回転 (かいてん): Drehung, Umdrehung, Rotation, Umlauf, Zirkulation, sich drehen, kreisen, rotieren
淡水 (たんすい): Süßwasser
括弧 (かっこ): Klammer
蛇口 (じゃぐち): Wasserhahn, Hahn, Spund
下降 (かこう): Herabkommen, Herabgehen, Herunterfliegen, Sinken, Abstieg, Sturz, Niedergang, hinuntergehen, herabgehen, hinunterkommen, hinunterfliegen, sinken, herunterfahren, heruntergleiten
包丁 (ほうちょう): (1) großes Küchenmesser, (2) Kochen, (3) Koch
朗らか (ほがらか): (1) heiter, fröhlich, (2) klar, hell
兵隊 (へいたい): (1) Soldat, (2) Matrose (mit niederem Dienstgrad), (3) Soldatentrupp, (4) jmd. ohne Posten
お手伝いさん (おてつだいさん): Hausmädchen, Haushaltshilfe
概論 (がいろん): Grundriss, Einführung, Einleitung
着せる (きせる): (1) jmdn. anziehen, jmdn. zudecken, (2) jmdm. die Schuld zuschieben, jmdn. verantwortlich machen, jmdn. beschuldigen, jmdn. anklagen, (3) plattieren, vergolden, versilbern, verchromen, (4) mit etwas überziehen, (5) lackieren, (6) schlagen
従姉妹 (いとこ): Cousine, Base
明明後日 (しあさって): überübermorgen, in drei Tagen
錆びる (さびる): rosten, verrosten, Rost ansetzen, rostig werden
独り言 (ひとりごと): Selbstgespräch, Monolog
背負う (せおう): (1) auf dem Rücken tragen, schultern, auf sich nehmen, (2) eingebildet sein, sich etw. einbilden, (1) auf dem Rücken tragen, auf die Schulter nehmen, schultern, auf den Rücken nehmen, (2) mit etw. belastet werden, etw. am Hals haben, (3) im Rücken platzieren, den Rücken zukehren, (4) im Rücken befinden
貸間 (かしま): Mietzimmer, gemietetes Zimmer, möbliertes Zimmer
止まる (とどまる): (1) bleiben, stehen bleiben, zum Stillstand kommen, anhalten, (2) aufhören, (3) sich niederlassen, (4) behalten, (5) sich beschränken
無数 (むすう): Zahllosigkeit, Unzählbarkeit, unzählbar, nicht zu zählend, zahllos, unzählig, zahllos
着替え (きがえ): (1) Wechseln der Kleidung, (2) Kleidung zum Wechseln
教わる (おそわる): Unterricht nehmen, unterrichtet werden, lernen, studieren
属 (ぞく): (1) Gattung (Taxonomie), (2) einfacher Beamter, Unterbeamter, (3) Zugehörigkeit
私鉄 (してつ): Privatbahn
甘やかす (あまやかす): (1) verwöhnen, (2) verhätscheln, verzärteln, verpäppeln, verziehen
南米 (なんべい): Südamerika
将棋 (しょうぎ): (1) Shōgi (Art japanisches Schachspiel), (2) Xiangqi
要領 (ようりょう): (1) Hauptpunkt, Kernpunkt, Kern, (2) Abriss, Essenz, Zusammenfassung, Grundzüge, (3) Kniff, Handgriff
展開 (てんかい): (1) Entwicklung, Entfaltung, Fortgang, (2) Aufmarsch in Linien, (3) Dekompression, (1) sich entfalten, sich entwickeln, sich ausweiten, (2) dekomprimieren, extrahieren
吐く (つく): (1) atmen, Atem holen, (2) ausspucken, (3) von sich geben, sagen, äußern
高等 (こうとう): hohes Niveau, hoher Grad, hoch, höher
全般 (ぜんぱん): das Ganze, Allgemeinheit, Gesamtheit, allgemein, ganz, gesamt
宣伝 (せんでん): Werbung, Reklame, Propaganda, propagieren, Propaganda machen, werben, Werbung machen, anpreisen
映す (うつす): (1) (sich) spiegeln, reflektieren, (2) projizieren, abbilden (auf der Leinwand, einer braunschen Röhre etc.)
海洋 (かいよう): See, Meer, Ozean, Weltmeer
上下 (じょうげ): (1) Oben und Unten, Auf und Ab, vertikales Schwanken, (2) etw. für Oben und Unten, auf und ab gehen, hoch und nieder gehen
包装 (ほうそう): Verpackung, einpacken, verpacken
我が (わが): mein, unser
中指 (なかゆび): (1) Mittelfinger, (2) mittlere Zehe
味わう (あじわう): (1) genießen, kosten, schmecken, probieren, abschmecken, (2) schätzen, studieren, (3) erfahren, erleben, erleiden
溶け込む (とけこむ): verschmelzen, sich in etw. auflösen, sich einleben, sich eingewöhnen
縫う (ぬう): (1) nähen, sticken, (2) sich durchschlängeln
伯父 (おじ): Onkel, Onkel, älterer Bruder von Vater oder Mutter, Onkel
衣食住 (いしょくじゅう): (1) Kleidung, Nahrung und Wohnung, die drei Grundbedürfnisse, (2) Lebensunterhalt
担ぐ (かつぐ): (1) auf den Schultern tragen, (2) abergläubisch sein, (3) aufstellen, auf den Schild heben, wählen, (4) linken, täuschen, hereinlegen, auf den Arm nehmen
濡らす (ぬらす): nass machen, anfeuchten, befeuchten, einweichen, durchnässen, eintauchen
中性 (ちゅうせい): (1) Geschlechtslosigkeit, Neutralität, (2) Neutrum, (3) Neutralität, (1) neutral, (2) sächlich, neutral
相互 (そうご): Gegenseitigkeit, Reziprozität, auf Gegenseitigkeit, gegenseitig, einander, gegenseitig, einander, reziprok
裏返す (うらがえす): (1) wenden, umkehren, das Innere nach außen kehren, (2) etw. von einer anderen Seite betrachten
手ぬぐい (てぬぐい): Tenugui, japanisches Handtuch
定期券 (ていきけん): Zeitfahrkarte, Dauerkarte, Saisonkarte, Monatskarte
産地 (さんち): Produktionsgebiet, Anbaugebiet, Heimat
地下水 (ちかすい): Grundwasser
期 (き): (1) Zeit, Zeitspanne, Zeitraum, Zeitdauer, Periode, Jahreszeit, Saison, (2) Alter, Stadium, (3) Amtszeit, (4) Sitzungsperiode
リズム: Rhythmus
敷地 (しきち): Grundstück, Platz, Gelände
略す (りゃくす): (1) verkürzen, abkürzen, auslassen, vereinfachen, (2) auf Formalitäten verzichten
人差し指 (ひとさしゆび): Zeigefinger
何しろ (なにしろ): (1) auf jeden Fall, schließlich, (2) wie du weißt, wie Sie wissen
地帯 (ちたい): (1) Zone, Gebiet, Region, (2) Klimazone
透明 (とうめい): Transparenz, Durchsichtigkeit, Transparenz, Durchsichtigkeit, Klarheit, durchsichtig, transparent, klar
瞳 (ひとみ): Pupille, Hitomi, Pupillen…
祭る (まつる): (1) eine Totenmesse feiern, (2) als Gottheit verehren, anbeten
ひとり子 (ひとりご): Einzelkind
名字 (みょうじ): Familienname, Zuname, Nachname
計 (けい): (1) Plan, (2) Gesamtbetrag, Summe, (3) (als Suffix)…‑Messgerät, …messer
現に (げんに): (1) tatsächlich, in der Tat, in Wirklichkeit, (2) zum Beispiel, um ein Beispiel anzuführen
史 (し): Geschichte, Historie, Geschichtsbuch, Chronik
但し (ただし): aber, jedoch, allerdings, nur, nur dass …, außer dass …, allein
脂 (あぶら): (1) (tierisches)Fett, Talg, Schmiere, festes Fett, (2) Unterhautfett, Speck, Blubber (bei Wal, Robbe etc.), Walspeck, (3) Schweiß
ドット: Punkt
嫌がる (いやがる): nicht mögen, etw. auszusetzen haben, Abneigung hegen, verabscheuen
率土 (そっと): Grenzgebiet, Küstengebiet
半径 (はんけい): Halbmesser, Radius
個体 (こたい): (1) Individuum, (2) Einzelexemplar, Individuum
住まい (すまい): Wohnung, Wohnsitz, Adresse, Wohnung
開会 (かいかい): Eröffnung einer Versammlung, Eröffnung einer Sitzung, (1) eine Versammlung eröffnen, (2) tagen
生意気 (なまいき): Vorlautheit, Frechheit, Naseweisheit, vorlaut, frech, naseweis, vorwitzig, frech, in frecher Weise, vorwitzig, naseweis
統計 (とうけい): Statistik, eine Statistik zusammenstellen, statistisch
発想 (はっそう): (1) Einfall, Idee, (2) Konzeption, (3) Ausdruck (in der Musik)
機 (き): (1) Gelegenheit, Chance, Anlass, Zeit, (2) Maschine, Flugzeug, (3) Funktion
ピストル: Pistole, Revolver
周辺 (しゅうへん): Umkreis, Peripherie
性別 (せいべつ): Geschlechtsunterschied
打ち合わせ (うちあわせ): Verabredung, Besprechung, Vorbesprechung, Beratung
上級 (じょうきゅう): höherer Rang, Oberklasse, obere Klasse
執筆 (しっぴつ): Verfassen, Schreiben, schreiben, verfassen
宛名 (あてな): Adresse, Anschrift
物凄い (ものすごい): (1) schrecklich, furchtbar, scheußlich, grässlich, grauenhaft, schauderhaft, gruselig, (2) irrsinnig, wahnsinnig, gewaltig, außergewöhnlich
伝記 (でんき): Biographie, Lebensbeschreibung
蓄える (たくわえる): (1) aufbewahren, speichern, lagern, aufspeichern, sparen, (2) tragen, wachsen lassen (Haare, einen Bart)
水平 (すいへい): Horizontale, Waagrechte, horizontal, waagrecht
御免 (ごめん): (1) (2) 
助かる (たすかる): (1) gerettet werden, sich retten, (2) helfen, nützlich sein
貸し (かし): Schuld
激増 (げきぞう): starke Zunahme, plötzliche Zunahme, stark zunehmen, plötzlich zunehmen
編集 (へんしゅう): Kompilation, Redaktion, kompilieren, redigieren, (1) Redaktion, Schriftleitung, Kompilation, Herausgabe, (2) Bearbeitung, (3) Schnitt, (1) herausgeben, druckfertig machen, redigieren, zusammentragen, (2) schneiden (einen Film)
ギャング: Gangster, Gang
実物 (じつぶつ): Original, Echtes, Ding, Sache, (mn) Realien, Gegenstand
温める (あたためる): wärmen, aufwärmen, heizen, wärmen, (1) wärmen, aufwärmen, heizen, (2) eine Beziehung erneuern, wieder vertraut werden, eine Störung in der Beziehung überwinden, (3) überarbeiten (ein Manuskript, einen Plan), eine Veröffentlichung aufschieben, um etw. zu verbessern
椀 (わん): Schale (椀 bezeichnet eine Holzschale und 碗 eine Schale aus Keramik)
加熱 (かねつ): Erhitzen, Erwärmen, erhitzen, erwärmen
肘 (ひじ): Ellbogen
スピーカー: (1) Lautsprecher, (2) Sprecher, Redner
艶 (つや): (1) Glanz, Glätte, (2) Lebhaftigkeit, (3) Interesse, Charme, (4) Übertreibung, Ausschmückung
暖か (あたたか): (1) warm, heiß, (2) warmherzig, freundlich, liebevoll, (3) finanziell gut gestellt, (4) warm, in einer warmen Farbe, Wärme, (1) warm, mild, (2) warmherzig, freundlich, herzlich, (1) warm, (2) warmherzig, in warmherziger Weise
風船 (ふうせん): Luftballon, Ballon
鉄砲 (てっぽう): (1) Gewehr, Flinte, (2) Stossen der Hand gegen einen Pfosten (Trainingsmethode), (3) Stoss beider Hände gegen die Brustgegend des Gegners , (4) etwas, das einem Gewehr ähnlich sieht oder in der Funktion ähnelt (wie Feuerungsrohr eines japan. Bades, Norimaki, Fugu-Fisch, beidhändiges Stoßen im Sumō u.A.)
仮名 (かな): Kana, Hiragana und Katakana, die beiden japanischen Silbenschriften
冷ます (さます): (1) abkühlen, kühlen, (2) verderben (z.B. den Spaß)
狙う (ねらう): (1) beabsichtigen, zielen auf, zielen, visieren, anvisieren, aufs Korn nehmen, (2) lauern, abpassen, nachstellen
解放 (かいほう): Befreiung, Freilassung, Emanzipation, befreien, freilassen, in Freiheit setzen, entlassen
書籍 (しょせき): Buch, Bücher
国立 (こくりつ): staatlich, Staats…, National…
追い越す (おいこす): überholen, hinter sich lassen, vorbeigehen, übertreffen, überbieten
見つめる (みつめる): anstarren, unverwandt ansehen
踏切 (ふみきり): (1) Bahnübergang, (2) Absprung, Absprungstelle, (3) Übertreten der Ringgrenze, (4) Entschluss
著す (あらわす): veröffentlichen, schreiben, verfassen
ラッシュアワー: Stoßzeit, Hauptverkehrszeit
系統 (けいとう): (1) System, Formation, (2) Abstammung, Abstammungslinie, Vorfahren, Ahnen, Nachkommen, (3) Partei, Clique, Schule
地点 (ちてん): Punkt, Stelle, Ort, geographischer Punkt
固まる (かたまる): (1) hart werden, sich verhärten, fest werden, (2) erstarren, gerinnen, sich verdichten, gefrieren, (3) sich zusammendrängen, sich versammeln, einen Haufen bilden, sich zusammenscharen, sich ballen, (4) sich festigen, sich stabilisieren, (5) sich hingeben, sich konzentrieren, sich begeistern, (6) seinen Lebenswandel verbessern
垣根 (かきね): (1) Zaun, Hecke, (2) Schutzwall, Absicherung, (3) Basis eines Zauns
所々 (ところどころ): hier und da, hier und dort, an verschiedenen Stellen, zerstreut, (1) überall, allerorten, allenthalben, (2) hier und dort
羨む (うらやむ): beneiden, neidisch sein, missgönnen
売り切れる (うりきれる): ausverkauft sein, nichts mehr vorrätig haben
懸命 (けんめい): Eifer, Fleiß, Anstrengung, (1) eifrig, fleißig, unverdrossen, (2) aus Leibeskräften
挟む (はさむ): (1) einklemmen, zwischen etw.klemmen, unter etw. klemmen, (2) einlegen, einschieben, einstecken, zwischen etw. stecken, (3) sich zwischen etw. befinden, zwischen etw. liegen, (4) gegenüber von etw. liegen, (5) unterbrechen, (6) erfahren
殻 (から): (1) Hülse (von Bohne), Hülle, Schale (von Korn, Nuss, Ei, Muschel etc.), (2) das eigene Schneckenhaus, Schutzpanzer, (3) abgeworfene Haut (z.B. einer Schlange), (4) leerer Chitinpanzer (z.B. einer Larve), (5) O・kara (Reste von der Tōfu-Produktion; gekocht od. gebraten als Nebengericht gegessen), (6) sterbliche Hülle, Leichnam
基地 (きち): Stützpunkt, Basis, Basislager
初めに (はじめに): zuerst, am Anfang, am Beginn, zunächst, ursprünglich
実例 (じつれい): Beispiel, konkreter Fall, Präzedenzfall
三日月 (みかづき): (1) Mondsichel, zunehmender Mond,  (ursprüngl.)Form des Mondes am dritten Tag des Mondkalenders, (2) Nō-Maske eines männlichen Rachegeistes mit goldumrahmten Augen
掛け算 (かけざん): Multiplikation
だらし無い (だらしない): (1) schlampig, unordentlich, (2) undiszipliniert, nachlässig, unachtsam, lose, schmutzig
続々 (ぞくぞく): einer nach dem anderen, hintereinander, nacheinander, ununterbrochen, in rascher Folge, in großer Menge
来日 (らいにち): Kommen nach Japan, Besuch von Japan, Ankunft in Japan, nach Japan kommen, Japan besuchen, in Japan ankommen
主語 (しゅご): Subjekt
部首 (ぶしゅ): Radikal, Klassenzeichen von Kanji
長短 (ちょうたん): (1) Länge, (2) Vor‑ und Nachteile
比較的 (ひかくてき): vergleichsweise, verhältnismäßig, relativ
パンツ: (1) Unterhose, Slip, (2) Badehose, kurze Hose
図鑑 (ずかん): (1) illustriertes Buch, illustriertes Lexikon, Bilderlexikon, (2) Bestimmungsbuch (für Pflanzen, Insekten o.Ä.)
切っ掛け (きっかけ): Gelegenheit, Anlass, günstiger Augenblick, Gunst des Augenblicks, Ansatz
探る (さぐる): (1) suchen, (2) tasten, tappen, (3) sich erkundigen, auskundschaften, erforschen
間接 (かんせつ): indirekt, mittelbar, indirekt
神様 (かみさま): (1) Gott, Gottheit, der liebe Gott, (2) jmd., der etw. ausgesprochen gut kann
咥える (くわえる): (1) im Mund halten, zwischen den Zähnen halten, (2) jmdn. mitbringen, jmdn. mitnehmen
家屋 (かおく): (1) Wohnhaus, Haus, Wohngebäude, (2) (nach dem Gesetz über kommunale Steuern)Gebäude (wie Wohnhaus, Laden, Fabrik oder Lagerhaus)
改正 (かいせい): Verbesserung, Revision, Reform, Änderung zum Vorteil, Umänderung, revidieren, verbessern, ändern, abändern, reformieren
間もなく (まもなく): in Kürze, gleich, bald, umgehend, sofort
夕刊 (ゆうかん): Abendzeitung, Abendausgabe
反 (はん): (1) Antithese, (2) Fǎnqiè (alte chin. Methode zur Darstellung der Aussprache eines unbekannten Kanji mittels zwei oder drei anderer Kanji als Kennzeichen für Fǎnqiè; Abk.)
粗筋 (あらすじ): Inhaltsübersicht, grobe Übersicht, grober Überblick, Abriss, Umriss, Auszug, Hauptpunkte, Resümee
長方形 (ちょうほうけい): Rechteck, Oblong, rechteckig
原産 (げんさん): ursprüngliche Herkunft, ursprüngliche Produktion
発射 (はっしゃ): (1) Abfeuern, Abschießen, Abdrücken, (2) Feuer!, (3) Raketenstart, Raketenabschuss, abfeuern, abschießen, abdrücken
例外 (れいがい): Ausnahme, außergewöhnlich, Ausnahme…
ポスター: (mn) Poster, Plakat
迫る (せまる): (1) näher rücken, heranrücken, näher kommen, sich nähern, nahen, bevorstehen, nahe sein, (2) sich verengen, (3) nötigen, erzwingen, pressen, drängen, anspornen, (4) auf den Pelz rücken, jmdm. zusetzen, (5) in die Enge getrieben werden, (6) Atembeklemmung bekommen
承る (うけたまわる): (1) hören, vernehmen, zu Ohren bekommen, erfahren, (2) empfangen, erhalten
吹雪 (ふぶき): Schneesturm, Schneegestöber
摩擦 (まさつ): Reiben, Reibung, Reiberei, Friktion, Zusammenstoß, reiben
広さ (ひろさ): (1) Ausdehnung, Fläche, Größe, (2) Breite, Weite, (3) Ausmaß, (4) Großzügigkeit, Toleranz
名作 (めいさく): Meisterwerk
女房 (にょうぼう): (1) (eigene)Ehefrau, bessere Hälfte, (2) (früher)Hofdame
マスク: (1) Mundmaske, Mundschutz, Maske, Gesichtsschutz (z.B. beim Fechten od im Baseball), (2) Gesicht, (3) Maskierung, (4) Maskierung
付属 (ふぞく): (1) Zugehörigkeit, Angliederung, (2) Neben…, (3) Sekundär…, (4) Weitergabe buddhidtischer Geheimnisse vom Lehrer zum Schüler, (5) (Abk. f.) angegliederte Schule, zugehören, gehören zu, angegliedert sein, zugehörig sein, angeschlossen sein
清い (きよい): (1) rein, sauber, klar, (2) unschuldig, keusch, unverdorben, schuldlos, unbescholten, edelmütig, platonisch
受取り (うけとり): Quittung, Empfangsschein, Empfang, Annahme
元々 (もともと): (1) Unverändertheit seit dem Anfang, (2) von Anfang an, eigentlich, ursprünglich, von Natur aus, von früher her, (3) wie früher, wie es war
麓 (ふもと): Fuß eines Berges, Bergfuß
内科 (ないか): (1) innere Medizin, (2) innere Abteilung, internistisch
全集 (ぜんしゅう): gesammelte Werke, Gesamtausgabe
皮膚 (ひふ): Haut, Haut…, kutan
掻く (かく): (1) sich kratzen, sich jucken, (2) scharren, kratzen, (3) hobeln (Katsuo), zerstoßen (Eis), (4) rechen, harken, (5) wegschaufeln, schippen, (6) paddeln, den Arm od. das Ruder durchs Wasser ziehen, (7) köpfen, (8) schwitzen
段階 (だんかい): Stufe, Stufenfolge, Stadium, Phase
爪 (つめ): (1) Nagel, Fingernagel, Fußnagel, (2) Kralle, Klaue, Huf, (3) Fingerplektrum
開通 (かいつう): Eröffnung (für den Verkehr), Freigabe, für den Verkehr öffnen, für den Verkehr freigeben
休講 (きゅうこう): Ausfallen der Vorlesung, die Vorlesung ausfallen lassen, die Vorlesung ausfallen lassen müssen
補う (おぎなう): ergänzen, ersetzen, entschädigen
並行 (へいこう): (1) Parallelismus, paralleler Verlauf, (2) Gleichlaufen, parallele Bewegung, (1) parallel verlaufen, (2) gleichauf sein, Schritt halten, nebeneinander laufen, gleichzeitiges Geschehen, gleichzeitiges Tun, Parallelismus, Gleichlaufen, parallel laufen, gleich laufen, parallel, gleichlaufend
関わる (かかわる): sich klammern an …, sich festhalten …, (1) zu tun haben mit …, sich befassen, (2) sich festhalten an …, gebunden sein …, (3) angehen, betreffen, beeinflussen, eine Wirkung ausüben
妥当 (だとう): Angemessenheit, Gültigkeit, Richtigkeit, Vernünftigkeit, angemessen, angebracht, geeignet, richtig, passend
等分 (とうぶん): Teilung in gleiche Teile, etw. in gleiche Teile teilen
挿す (さす): (1) einfügen, (2) stecken (z.B. Blumen)
ヘル: Hel (Göttin der Unterwelt), Hölle, Herr
通ずる (つうずる): (1) sich auskennen, Bescheid wissen, (2) verstanden werden, sich verständigen können, erhört werden, (3) führen, gehen nach, eröffnet werden, (4) heimlich in Verbindung treten, sich heimlich in Verbindung setzen, in Verbindung stehen mit, (5) einen Telefonanschluss bekommen, eine Verbindung bekommen, (6) Strom einschalten
原理 (げんり): Theorie, Prinzip, Grundbegriff, Grundgedanke, Grundsatz, Hauptgesichtspunkt
手入れ (ていれ): (1) Pflege, Betreuung, Wartung, (2) Reparatur, Ausbesserung, Instandsetzung, Renovierung, (3) Razzia, (1) pflegen, unterhalten, (2) reparieren, ausbessern, (3) ein Razzia machen
断水 (だんすい): Absperrung der Wasserleitung, Unterbrechung der Wasserzufuhr, das Wasser absperren
学級 (がっきゅう): Schulklasse, Klasse
通り掛かる (とおりかかる): vorbeikommen, vorbeigehen
消耗 (しょうもう): (1) Verbrauch, Konsum, (2) Abnutzung, Abzehrung, (1) verbrauchen, konsumieren, (2) verschleißen, abnutzen, einen oder etw. mitnehmen
剥がす (はがす): (1) abkratzen, abnehmen, abreißen, (2) abhäuten, abbalgen, abstreifen, (3) entlarven
治める (おさめる): (1) regieren, verwalten, (2) beherrschen, unterdrücken, (3) managen, verwalten
無地 (むじ): Ungemustertheit, Uni, ungemustert, uni
一々 (いちいち): (1) (2) 
匂う (におう): (1) duften, riechen, (2) glänzen, strahlen, blühen, (1) stinken, übel riechen, (2) anrüchig sein, einen zweifelhaften Ruf haben
見直す (みなおす): (1) noch einmal sehen, (2) (sein Urteil) revidieren, nochmals überprüfen, (3) sich erholen, sich verbessern, (4) sich über etw. neu Gedanken machen
ベテラン: Veteran, Experte, Fachmann, Alter Hase, Erfahrener, bewährt, altgedient, Veteran, Experte, Fachmann, alter Hase, Erfahrener
シャッター: (1) Verschluss, (2) Laden, Fensterladen, Rollladen
坊さん (ぼうさん): buddhistischer Priester, Mönch (freundlich-höfliche Bez.)
突き当たる (つきあたる): stoßen auf etw, enden
絵の具 (えのぐ): Farbe, Farbstoff
やむを得ない (やむをえない): unvermeidlich, unumgänglich, nötig, notgedrungen, es ist nichts zu machen
潰れる (つぶれる): (1) zerbrechen, zusammenbrechen, einstürzen, aufplatzen, zerplatzen, kaputt gehen, (2) zerstört werden, (3) Pleite gehen
商社 (しょうしゃ): Handelsgesellschaft, Handelshaus, Firma
深まる (ふかまる): tiefer werden, stärker werden, intensiver werden
日日 (ひにち): (1) Tag, Datum, Termin, (2) Zeit
呉れ呉れも (くれぐれも): tausendmal, wiederholt, wieder und wieder, aufrichtigst
方程式 (ほうていしき): Gleichung
メニュー: (1) Menü, Speisekarte, Karte, (2) Übersichtsplan (Sachen, die man tun soll oder tun kann bzw. diese Sachen selbst), Stundenplan, Ablaufplan, (3) Menü (auf der Benutzeroberfläche angezeigte Liste der zur Verfügung stehenden Funktionen eines Programms)
疾っくに (とっくに): (1) längst, (2) vor langer Zeit
凍える (こごえる): frieren, durchgefroren sein, taub sein (vor Kälte)
各地 (かくち): (1) jeder Ort, jede Gegend, überall, verschiedene Gegenden, (2) hier und da
茶色い (ちゃいろい): braun
煙突 (えんとつ): (1) Schornstein, Ofenrohr, (2) Betrug des Fahrgastes durch einen Taxifahrer, indem dieser den Taxameter nicht verwendet und beim Fahrpreis schwindelt
誓う (ちかう): schwören, beteuern, geloben, feierlich versprechen, ein Gelübde ablegen
睨む (にらむ): (1) scharf ansehen, anstarren, hinstarren, (2) im Auge behalten, verdächtigen, (3) für etw. ansehen, abschätzen
内線 (ないせん): (1) Nebenanschluss, Nebenstelle, Apparat, (2) Hausverkabelung, interne Verkabelung
作成 (さくせい): Anfertigung, Abfassung, Entwurf, anfertigen, abfassen, entwerfen, schreiben, verfassen
金魚 (きんぎょ): Goldfisch, Carassius auratus
持ち (もち): (1) Haltbarkeit, Lebensdauer, (2) Übernahme von Kosten, (3) für …
待合室 (まちあいしつ): Warteraum, Wartezimmer, Wartesaal
倣う (ならう): nachahmen, kopieren, zum Muster machen, nacheifern, folgen, sich richten nach
格別 (かくべつ): (1) (2) , besonders, insbesondere, eigens, speziell, vorwiegend, besonderer, extra, spezieller
香水 (こうすい): Parfüm, Duftwasser
中年 (ちゅうねん): mittleres Alter, reifes Alter, in mittleren Jahren, mittleren Alters
工員 (こういん): Fabrikarbeiter, Industriearbeiter, Facharbeiter
痒い (かゆい): (1) jucken, kitzeln, kribbeln, (2) juckend, kitzelnd, kribbelnd
校 (こう): (1) Schule, (2) Korrigieren, Korrekturlesen
寒帯 (かんたい): arktische Erdzone, Polarzone
高める (たかめる): erhöhen, heben, emporheben, verbessern
月給 (げっきゅう): Monatsgehalt, Monatslohn
近々 (ちかぢか): bald, nächstens, demnächst, dieser Tage, in absehbarer Zeit, in nächster Zeit, über kurz oder lang
目覚まし (めざまし): (1) Wecker (Abk.), (2) Aufwachen, (3) Süßigkeit, die Kinder nach dem Aufwachen bekommen
素人 (しろうと): Laie, Dilettant, Amateur, Uneingeweihter, Liebhaber (Aussprache aus Onbin von shiro・hito entstanden), laienhaft, amateurhaft
兎も角 (ともかく): (1) abgesehen von, (2) auf jeden Fall, jedenfalls, auf alle Fälle, immerhin, sowieso
回答 (かいとう): Antwort, Erwiderung, Entgegnung, antworten, beantworten, entgegnen, eine Antwort geben
剥く (むく): schälen, pellen
のろのろ: ganz langsam
紺 (こん): Dunkelblau
濃度 (のうど): (1) Dichte, (2) Konzentration, (3) Mächtigkeit, Kardinalität
すっきり: frisch, klar, schön, sich frisch fühlen, sich wohl fühlen, frisch, klar, schön
対照 (たいしょう): Kontrast, Gegensatz, Antithese, Vergleich, Gegenüberstellen, gegenüberstellen, in Gegensatz stellen, vergleichen, kontrastieren
箇所 (かしょ): Stelle, Ort, Fleck, Punkt, Teil, Passage
反省 (はんせい): Selbstkritik, Selbstprüfung, Nachdenken über sich selbst, Reflexion, sich selbst prüfen, über sich selbst nachdenken
伯母 (おば): Tante, Tante, ältere Schwester des Vaters oder der Mutter, Tante
留守番 (るすばん): (1) Haushüten, (2) Haushüter
率直 (そっちょく): Aufrichtigkeit, Offenheit, Offenherzigkeit, Freimut, Geradheit, aufrichtig, offen, offenherzig, aufrichtig, freimütig, gerade, offen, offenherzig
坊や (ぼうや): (1) Junge, Sohn, (2) Milchbart, Jüngelchen, Greenhorn, (3) mein Junge, mein Kleiner
押さえる (おさえる): (1) niederhalten, niederdrücken, zu Boden zwingen, (2) unterdrücken, niederhalten, (3) beherrschen, kontrollieren, in Schach halten, (4) senken (die Stimme), (5) festhalten, mit den Händen halten, (6) fangen, festnehmen, (7) punktlos halten, (8) pfänden, beschlagnahmen
湧く (わく): (1) heraussprudeln, hervorquellen, herausströmen, (2) wachsen, sich entwickeln
縛る (しばる): (1) binden, fesseln, verbinden, zubinden, verschnüren, anbinden, (2) in Anspruch nehmen, an etw. binden
分解 (ぶんかい): (1) Zerlegung, Demontage, Auseinandernehmen, Analyse, (2) Analyse, Aufspaltung, (3) Cracken, Kracken, (4) Partition, (1) auseinander nehmen, demontieren, zerlegen, (2) analysieren, aufspalten, (3) cracken, (4) partitionieren
仲直り (なかなおり): Versöhnung, Beilegung, sich versöhnen, sich aussöhnen, einen Streit beilegen, sich wieder vertragen
繋がる (つながる): (1) verbunden sein, Verbindung bekommen, (2) zu etw. führen, (3) jmdn. erreichen, am Telefon durchkommen, (4) verwandt sein, verbunden sein
実感 (じっかん): lebhafter Eindruck, Lebhaftigkeit, unmittelbares Gefühl, unmittelbare Empfindung, Lebendigkeit, etw. wirklich fühlen, etw. wahrnehmen
南北 (なんぼく): Süden und Norden, Nordsüd…
枯れる (かれる): (1) welken, verwelken, absterben, verdorren. vertrocknen, (2) seine Kraft verlieren, schwach werden, (3) alt werden, altern, (4) reifen, ausreifen, (5) sterben und vertrocknen, (6) verschorfen, austrocknen (eine Wunde)
水筒 (すいとう): Feldflasche, Reiseflasche
交差 (こうさ): (1) Kreuzung, Gabelung, (2) Überschneidung, (3) Intersektion, Durchschnitt, Schnitt, (4) Kreuzung, Kreuzzüchtung, sich kreuzen
尻尾 (しっぽ): (1) Schwanz, Schwanzflosse, (2) Ende
杉 (すぎ): japanische Zeder, Sicheltanne, Cryptomeria japonica
御中 (おんちゅう): An die Firma …, An … (Ausdruck der bei Schreiben an Firmen und Institutionen an deren Namen gefügt wird)
真似る (まねる): imitieren, nachahmen, nachmachen, nachäffen
コンセント: Steckdose
ロビー: (1) Foyer, Lobby, Vorhalle, Wandelhalle, Wandelgang, (2) Wandelgang des Parlaments, (3) Lobby, Interessenvertretung
通 (つう): Kenner, Experte, Connaisseur
以降 (いこう): seit …, von … an, ab …, nach …
至急 (しきゅう): Dringlichkeit, schnellstens, so schnell wie möglich, baldmöglichst, dringend, dringlich, drängend
全力 (ぜんりょく): die ganze Kraft, alle Kräfte
郵送 (ゆうそう): Postversand, mit der Post senden
両側 (りょうがわ): beide Seiten, an beiden Seiten
スケジュール: Programm, Plan
図表 (ずひょう): Diagramm, Tafel, Tabelle, grafische Darstellung
相変わらず (あいかわらず): wie immer, wie sonst, nach wie vor, unverändert, ständig
部品 (ぶひん): Ersatzteile, Zubehör, Zubehörteile, Komponente, Teil
退ける (のける): wegschaffen, aus dem Weg räumen, (1) wegnehmen, entfernen, aus dem Weg räumen, (2) sich durchschlagen, (1) entfernen, beseitigen, fortschaffen, wegnehmen, wegräumen, wegschaffen, wegtun, aus dem Weg räumen, (2) auslassen, weglassen, ausschließen, ausnehmen, beiseite legen, (3) fertig bringen, schaffen, managen, bewerkstelligen
両 (りょう): Ryō (historische Gewichtseinheit für Silber und Gold; ab der Edo-Periode auch als Münzeinheit verwendet; verwendet)
しーん: ganz still, ohne Geräusch, (1) Szene, (2) Szenerie, Landschaft, ruhig
発揮 (はっき): Entfaltung, Zeigen, Offenbarung, entfalten, zeigen, offenbaren, beweisen, zur Geltung bringen
当てはめる (あてはめる): anwenden (z.B. eine Regel), gebrauchen
覗く (のぞく): (1) gucken, blicken, anschauen, einen Blick werfen, (2) herausgucken
割と (わりと): ziemlich, relativ, verhältnismäßig, vergleichsweise
三角 (さんかく): (1) drei Ecken, drei Kanten, (2) Dreieck, (3) (insbes.) gleichseitiges Dreieck (in der altjapan. Mathematik), (4) Säckchen in Dreicksform um Toso-Sake herzustellen
漢和 (かんわ): (1) Chinesisch und Japanisch, (2) (Han‑)China und Japan
主役 (しゅやく): Hauptrolle, Titelrolle, Hauptdarsteller, Held, Protagonist
行 (ぎょう): (1) Zeile, (2) (Zählwort für)Zeilen, (3) Askese, Selbstkasteiung, Kasteiung
平凡 (へいぼん): Alltäglichkeit, Mittelmäßigkeit, Durchschnitt, Gewöhnlichkeit, Mittelmaß, alltäglich, mittelmäßig, durchschnittlich, prosaisch, trivial
指定 (してい): Bestimmung, Designation, bestimmen, bezeichnen, festsetzen
敷く (しく): (1) belegen, überziehen, ausbreiten, auslegen, (2) verlegen (z.B. Schienen od. eine Wasserleitung), (3) pflastern, schottern, beschütten, (4) erlassen, verkündigen
縒り (より): Drehung, Verdrehung
真っ黒 (まっくろ): Tiefschwarz, Pechschwarz, Rabenschwarz, Kohlschwarz, (1) pechschwarz, kohlschwarz, rabenschwarz, schwarz wie Ebenholz, tintenschwarz, (2) braungebrannt, (3) schwärzlich und schmutzig
毛皮 (けがわ): Fell, Pelz, aus Pelz
工芸 (こうげい): (1) Kunstgewerbe, Kunsthandwerk, (2) Technik, Arbeitstechnik
オルガン: Orgel, Harmonium
ストップ: Stop, stoppen
大して (たいして):  (nicht) besonders,  (nicht) sehr (es folgt Negation)
口紅 (くちべに): (1) Lippenstift, Lippenrot, (2) Aufbringen eines roten Kreises auf dem Rand eines Gefäßes, (3) roter Kreis am Rand eines Gefäßes
幾分 (いくぶん): (1) (2) 
盆地 (ぼんち): Becken, Mulde, Senke, Kessel, Talkessel
饂飩 (うどん): Udon, Udon-Nudeln, Weizennudeln
広々 (ひろびろ): weit und breit, weit, ausgedehnt, weitläufig, groß, geräumig
ワンピース: einteilig,  (einteiliges)Kleid, Einteiler, One Piece (Manga von Oda Eiichirō)
親類 (しんるい): Verwandtschaft, Verwandte, Verwandter, verwandt
マラソン: Marathon, Marathonlauf (Langstreckenlauf über 42,2 km), Malathon (Wz.), Malathion (Insektizid)
鉢 (はち): (1) Topf, (2) Schüssel, Schale, (3) Schädel, Gehirnschale
若しかしたら (もしかしたら): vielleicht, möglicherweise, eventuell
イメージ: (1) Image, (2) Bild, (3) Imago, Vorstellung, Gedankenbild
診る (みる):  (ärztlich) untersuchen
水面 (すいめん): Wasseroberfläche, Wasserspiegel
兆 (ちょう): (1) Billion, 10¹², 1.000.000.000.000, (2) Omen, Vorzeichen, Anzeichen
リボン: (1) Band, Streifen, Schleife, (2) Farbband
ため息 (ためいき): Seufzer, Stoßseufzer
手帳 (てちょう): Notizbuch, Heft
頼もしい (たのもしい): (1) verlässlich, zuverlässig, vertrauenswürdig, (2) hoffnungsvoll, viel versprechend
在学 (ざいがく): Schüler-Sein, Schüler sein, Student sein, in der Schule sein
取り入れる (とりいれる): hereinnehmen, aufnehmen, übernehmen, einführen, ernten
コンクール: Wettbewerb
俳句 (はいく): Haiku (17-silbiges japanisches Gedicht mit einem Schema mit 5-7-5 Silben)
真っ青 (まっさお): (1) tiefblau, (2) kreidebleich, sehr bleich, (1) tiefblau, dunkelblau, (2) totblass, leichenblass, kreidebleich, kreideweiß
建つ (たつ): (1) errichtet werden, gebaut werden, (2) errichtet sein, stehen, aufragen
狙い (ねらい): Ziel, Absicht
話し中 (はなしちゅう): (1) im Gespräch sein, (2) besetzt sein (Telefon), im Gespräch, besetzt (Telefon)
纏まる (まとまる): (1) abgeschlossen werden, beendigt werden, fertig werden, zum Abschluss kommen, (2) gesammelt werden, zusammenkommen, (3) in Ordnung gebracht werden, geordnet werden, eine Form annehmen, (4) entschieden werden, Verständigung erzielen, (5) einheitlich sein, vereint sein, wohl geordnet sein
漁師 (りょうし): Fischer, Fischersmann
炊く (たく): kochen
逃がす (にがす): (1) freilassen, freigeben, (2) entkommen lassen
賞金 (しょうきん): Geldpreis, Preis, Belohnung
名詞 (めいし): Substantiv, Nomen
算数 (さんすう): (1) Rechnen, (2) Arithmetik, Mathematik
普及 (ふきゅう): Ausbreitung, Verallgemeinerung, Popularisierung, (1) verbreiten, ausbreiten, (2) sich verbreiten, sich ausbreiten
造船 (ぞうせん): Schiffbau, ein Schiff bauen
広げる (ひろげる): (1) verbreitern, breiter machen, ausdehnen, erweitern, (2) auffalten, aufschlagen, öffnen, auswickeln, aufspannen, spreizen, (3) ausbreiten, verteilen, (4) vergrößern, ausdehnen, ausweiten, (5) gedeihen lassen, entwickeln
悠々 (ゆうゆう): (1) Ruhe, Gelassenheit, Geruhsamkeit, Gefasstheit, (2) Lockerheit, (3) Grenzenlosigkeit, (1) ruhig, gelassen, gemächlich, geruhsam, gefasst, (2) locker, (3) grenzenlos, (1) ruhig, gelassen, gemächlich, geruhsam, gefasst, (2) ohne Problem, locker, (3) grenzenlos
調度 (ちょうど): (1) Hausrat, Möbel, Einrichtung, Utensilien, (2) Pfeil und Bogen
櫛 (くし): Kamm
是非とも (ぜひとも): auf jeden Fall, sicher
拵える (こしらえる): machen, herstellen, anfertigen, bauen, (1) herstellen, machen, anfertigen, fabrizieren, (2) bilden, bauen, konstruieren, (3) vorgeben, simulieren, vorspiegeln, vortäuschen
採点 (さいてん): Benotung, Zensur, benoten, zensieren, eine Note geben, mit einer Note begutachten, beurteilen
田んぼ (たんぼ): Reisfeld
区切る (くぎる): (1) abteilen, einteilen, gliedern, (2) gliedern (einen Satz, ein Gedicht, einen Aufsatz etc.), Abschnitte machen,  (einen Satz) in Phrasen aufteilen, phrasieren, (3) interpunktuieren, mit Satzzeichen versehen, (4) zum Abschluss bringen, ein Ende setzen, einen Punkt machen
開放 (かいほう): (1) Öffnen, Aufschließen, Erschließen, (2) Offenlassen einer Tür, (1) aufschließen, erschließen, öffnen, (2) offen lassen, offen stehen lassen, (3) der Öffentlichkeit übergeben, an die Öffentlichkeit bringen, veröffentlichen
通訳 (つうやく): Dolmetschen, Dolmetscher, dolmetschen, verdolmetschen
割引 (わりびき): (1) Ermäßigung, Preisnachlass, Rabatt, (2) Diskontierung (eines Wechsels)
追加 (ついか): Zusatz, Nachtrag, Ergänzung, hinzufügen, nachtragen, zusetzen, ergänzen, zusätzlich
揃う (そろう): (1) sich versammeln, sich treffen, (2) zusammengestellt werden, angeordnet werden, in Ordnung gebracht werden, (3) vervollständigt werden, ergänzt werden, vollzählig werden, (4) gleich sein, übereinstimmen
肯定 (こうてい): Zustimmung, Bejahung, Bestätigung, Affirmation, zustimmen, bejahen, bestätigen
臍 (へそ): (1) Nabel, Umbilicus, (2) etw., das dem Nabel ähnelt, (3) Zentrum, Nabel
農産物 (のうさんぶつ): landwirtschaftliches Erzeugnis, Agrarprodukt
所為 (せい): Folge, Ursache, Grund, Schuld, Fehler
移転 (いてん): (1) Umzug, Ortswechsel, (2) Übertragung eines Rechtes oder von Vermögen auf jmdn. anderen, (3) Änderung einer Situation, umziehen
起床 (きしょう): Aufstehen, Verlassen des Bettes, aufstehen, das Bett verlassen
構造 (こうぞう): (1) Struktur, System, Konstruktion, Bau, Aufbau, Bauart, Bauweise, Gerüst, Organisation, Zusammensetzung, (2) Satzbau, (3) Tektonik
煮える (にえる): kochen (intr.)
講師 (こうし): (1) Dozent, Lektor, (2) Vortragender, Redner
済み (ずみ): erledigt, abgeschlossen, beendet, OK
吊るす (つるす): aufhängen, tragen
発電 (はつでん): Stromerzeugung, Strom erzeugen
接近 (せっきん): (1) Annäherung, Herannahen, Nahen, (2) Angrenzen, Nahesein, (3) Rapprochement, Wiederannäherung, (1) sich annähern, näher kommen, (2) angrenzen, (3) sich näher kommen, besser mit jmdm. auskommen
騒がしい (さわがしい): (1) lärmend, laut, geräuschvoll, tobend, ungestüm, ohrenbetäubend, (2) unruhig, aufrührerisch, unfriedlich, (3) turbulent, aufgeregt, unruhig
めっきり: beträchtlich, bedeutend, beachtlich, bemerkbar, sichtlich
並木 (なみき): Namiki, Baumreihe, Namiki
栓 (せん): (1) Stöpsel, Pfropfen, (2) Pflock, Pfropfen, Spund, Stopfen, Verschluss, Bolzen, Hahn
句読点 (くとうてん): (1) Satzzeichen, Interpunktionszeichen, (2) Punkt und Komma
腰掛ける (こしかける): sich hinsetzen, Platz nehmen
油断 (ゆだん): Unachtsamkeit, Unaufmerksamkeit, Unvorsichtigkeit, Nachlässigkeit, unaufmerksam sein, nicht auf der Hut sein
囁く (ささやく): flüstern, murmeln, raunen, wispern
郡 (ぐん): Bezirk, Kreis, Landkreis (im Ritsuryō-System), (1) Landkreis, ländlicher Verwaltungsbezirk, (2) Bezirk (Gebietseinheit unterhalb einer Provinz; nach dem Ritsuryō-System), (3) Bezirk (Verwaltungseinheit der Qin- bis Sui-Dynastie)
粗 (あら): (1) ausgekochter Fisch (einer Suppe), Abfälle eines Fisches ,  (schäbiger)Überrest, (2) Fehler, Makel, Gebrechen, Unvollkommenheit, Ara
立ち止まる (たちどまる): anhalten, stehen bleiben, stillstehen
電柱 (でんちゅう): Strommast, Telegrafenmast, Telefonmast
インタビュー: Interview, interviewen, Interview
振る舞う (ふるまう): (1) sich benehmen, sich betragen, sich verhalten, sich aufführen, verfahren, (2) bewirten, einladen, zu Gast bitten, abfüttern
儲かる (もうかる): (1) Gewinn bringen, einträglich sein, lohnend sein, profitabel sein, rentabel sein, (2) Gewinn herausschlagen, ein Geschäft machen mit, gut verdienen mit
乾かす (かわかす): trocknen, austrocknen
特色 (とくしょく): Eigenart, charakteristisches Merkmal, Charakterzug
受け持つ (うけもつ): übernehmen, verantwortlich sein, betreuen, zuständig sein, Aufsicht führen
荒い (あらい): (1) rau, grob, barsch, wild, derb, ungestüm, unruhig, stürmisch, heftig, gewaltsam (z.B. Wind, Wellen), (2) harsch, grob, unfreundlich (z.B. Worte)
シリーズ: Serie, Reihe
速力 (そくりょく): Geschwindigkeit
カラー: Calla, Kalla, Zantedeschia, Farbe, Kragen, Paul Karrer (schweizer. Biochemiker; 1889–1971)
洒落 (しゃれ): Witz, Wortspiel
芯 (しん): (1) Kern, Kerngehäuse, (2) Docht, (3) Futter, (4) Mark, (5) Zentrum, Kern
芸能 (げいのう): Unterhaltung, Bühnenkunst, Schauspiel, Kunstfertigkeit
四季 (しき): die vier Jahreszeiten
中世 (ちゅうせい): (1) Mittelalter, (2) (in Japan) Kamakura‑ bis Muromachi-Zeit, (3) mittleres Alter
ランニング: (1) Rennen, Laufen, (2) ärmelloses Unterhemd (Abk.)
水平線 (すいへいせん): (1) Meereshorizont, (2) Horizontale, Horizontallinie
巡る (めぐる): (1) kreisen, sich drehen, rotieren, (2) herumreisen, herumfahren, umlaufen, zirkulieren, (3) sich wiederholen, (4) sich beziehen
毎度 (まいど): jedes Mal, immer
砕く (くだく): (1) zerbrechen, in Stücke schlagen, zermahlen, zerschmettern, (2) sich den Kopf zerbrechen, alles für etw. tun, sich quälen, (3) vereinfachen, einfach erklären
スライド: (1) Dia, Diapositiv, Dia-Film, (2) Projektor, Dia-Projektor, (3) Rutschen
その上 (そのうえ): außerdem, darüber hinaus, dazu, ferner, überdies
追いかける (おいかける): nachlaufen, verfolgen, hinter jmdm. herrennen, nachfolgen, nacheilen, nachrennen
酸っぱい (すっぱい): sauer, säuerlich, herb (auch übertr.)
時間割 (じかんわり): Stundenplan, Arbeitsplan
集合 (しゅうごう): (1) Versammlung, Treffen, Zusammenkunft, (2) Menge, sich versammeln, zusammenkommen, sich treffen
平野 (へいや): Ebene, Flachland
無沙汰 (ぶさた): langes Schweigen, langes Nicht-Besuchen, lange nichts von sich hören lassen
惜しい (おしい): (1) schade, bedauerlich, (2) teuer, kostbar, verschwenderisch, (3) zu gut, zu schade
実習 (じっしゅう): Praktikum, praktische Ausbildung, Praxis, Schulung, praktizieren, in der Lehre sein, praktisch ausüben
恵まれる (めぐまれる): gesegnet sein (mit …)
自然科学 (しぜんかがく): Naturwissenschaft
物語る (ものがたる): (1) erzählen, schildern, beschreiben, reden von etw, ausführen, (2) verraten, zeigen, belegen, beweisen
反映 (はんえい): Reflexion, Spiegelung, reflektieren, spiegeln
末っ子 (すえっこ): das jüngste Kind, das letztgeborene Kind
静まる (しずまる): (1) still werden, ruhig werden, (2) sich beruhigen, zur Ruhe kommen, sich legen, nachlassen, unterdrückt werden
中旬 (ちゅうじゅん): Mitte des Monats, zweites Drittel eines Monats
ジャーナリスト: Journalist
パターン: Muster, Anwendungsmuster
小便 (しょうべん): Harn, Wasser, Pisse, Harn, Urin, Wasser, Pisse, pinkeln, Wasser lassen, Harn lassen, harnen, pissen, schiffen
引き止める (ひきとめる): (1) aufhalten, zurückhalten, vom Gehen abhalten, am Gehen hindern, (2) hindern, hinderlich sein, im Weg stehen
思いがけない (おもいがけない): unerwartet, ungeahnt, unverhofft, unvermutet, unvorhergesehen
停電 (ていでん): Stromunterbrechung, Stromausfall, Stromsperre, der Strom ist gesperrt, der Strom ist unterbrochen, einen Stromausfall haben
極 (ごく): (1) Hervorragendheit, (2) etw. von höchster Qualität, (3) (meist in der Form goku no) hervorragend, überragend, (4) Tee von hervorragedner Qualität, (5) Oktillion, 10⁴⁸, (6) (als Adv.) sehr, äußerst, außergewöhnlich, enorm, im höchsten Grade, über alle Maßen, ungeheuer
本来 (ほんらい): (1) ursprünglich, anfänglich, (2) eigentlich, fundamental, konsequenterweise, (3) natürlich, von Natur aus, (4) rechtmäßig, eigentlich, (1) ursprünglich, urtümlich, (2) eigentlich, im Grunde genommen, (3) natürlich, (4) rechtmäßig
濁る (にごる): (1) sich trüben, trüb werden, (2) unrein werden, (3) nigorieren, die Nigori-ten schreiben, die diakritischen Zeichen für stimmhafte Vokale schreiben
分布 (ぶんぷ): (1) Verbreitung, Vorkommen, Ausbreitung, (2) Verteilung, (3) Wahrscheinlichkeitsverteilung, (1) vorkommen, verbreitet sein, (2) sich verbreiten
牧場 (ぼくじょう): (1) Weide, Wiese, (2) Viehfarm, Ranch, Weide, Wiese
代名詞 (だいめいし): Pronomen
火傷 (やけど): Brandwunde, Verbrennung, sich verbrennen, sich verbrühen, Brandwunde, Verbrennung
仕様が無い (しようがない): (1) da ist nichts zu machen, (2) da kann man nichts machen
溶岩 (ようがん): Lava
鈴 (すず): Klingel, Türglocke, Glocke, Schelle, Glöckchen, kleine Glocke, (1) Klingel, Glöckchen, Schelle, (2) Klangschale
列島 (れっとう): Inselkette, Archipel
撮影 (さつえい): Fotografieren, Filmen, Aufnahme, fotografische Aufnahme, filmen, einen Film drehen, fotografieren, knipsen
紅葉 (こうよう): (1) (rötliche)Laubfärbung, (2) rote Blätter, buntes Herbstlaub, rot werden (Laub), sich rot verfärben, sich herbstlich verfärben, sich verfärben, bunt werden, rot werden, gelb werden (Laub), (1) Herbstfärbung, (2) gelbe Blätter, buntes Herbstlaub, (1) buntes Herbstlaub, rotes Herbstlaub (insbes. Schreibung 紅葉), gelbes Herbstlaub (insbes. Schreibung 黄葉), (2) Ahorn, Acer, (3) Rehfleisch, Hirschfleisch, gelb werden, sich gelb verfärben
目印 (めじるし): Markierung, Orientierungspunkt, Kennzeichen, Zeichen, Merkmal
録音 (ろくおん): Tonaufnahme, Aufnahme, Schallaufzeichnung, aufnehmen, auf Band sprechen, auf Band spielen
公正 (こうせい): Billigkeit, Ehrlichkeit, Gerechtigkeit, Rechtlichkeit, Unparteilichkeit, billig, ehrlich, fair, gerecht, ohne falsch, rechtlich, unparteiisch
公式 (こうしき): (1) Formalität, Förmlichkeit, (2) Staats…, (3) Formel, formell, in formeller Weise, förmlich, offiziell, öffentlich, (1) formell, (2) förmlich, offiziell, öffentlich
足る (たる): genügen, ausreichen, wert sein
茹でる (ゆでる): kochen
近づける (ちかづける): (1) herankommen, sich nähern, in die Nähe kommen, (2) mit jmdm. Umgang haben, mit jmdm. verkehren
ひっくり返す (ひっくりかえす): (1) umkehren, umdrehen, (2) umwerfen, umstürzen, niederwerfen, (3) verkehrt herum aufstellen, umkehren, auf den Kopf stellen, (4) umschlagen
そそっかしい: unaufmerksam, unachtsam, gedankenlos, fahrig, unvorsichtig, unüberlegt, leichtsinnig
欲張り (よくばり): habgierig, gierig, begierig, habsüchtig, raffsüchtig, besitzergreifend, (1) Habgier, Gier, Geiz, (2) Nimmersatt, Geizhals
配る (くばる): (1) verteilen, austragen, liefern, ausliefern, abliefern, zuteilen, geben, ins Haus liefern, einteilen, (2) arrangieren, aufstellen, postieren, (3) zumessen, anweisen, aufteilen
斜め (ななめ): Schräge, Schiefheit, Abfallen, Neigung, schräg, schief, abfallend, diagonal, geneigt
大木 (たいぼく): hoch aufragender Baum, großer Baum, gigantischer Baum
灯台 (とうだい): (1) Leuchtturm, (2) Leuchter
懐かしい (なつかしい): (1) ersehnt, sehnlich vermisst, (2) Nostalgie verspürend, wehmütig zurückblickend, (3) lieb, teuer
お参り (おまいり): Besuch (eines Schreins o.Ä.), Schreinbesuch, Wallfahrt
緯度 (いど): Breitengrad, Latitüde, latitudinal
日当たり (ひあたり): (1) Sonnenausgesetztheit, Von-der-Sonne-Beschienensein, (2) sonniger Platz, besonnter Platz, von der Sonne beschienener Ort, Sonnenlage, Platz in der Sonne
唇 (くちびる): Lippe
地名 (ちめい): Ortsname
垂直 (すいちょく): Senkrechte, Vertikalität, vertikal, senkrecht
換気 (かんき): Belüftung, Lüftung, Ventilation, Luftwechsel, lüften, ventilieren, frische Luft zuführen
浮かぶ (うかぶ): (1) schwimmen, schweben, treiben, (2) auftauchen, erscheinen, sich zeigen, (3) in den Sinn kommen
実 (じつ): (1) Wirklichkeit, Tatsache, Substanz, (2) Treu, Aufrichtigkeit, Ehrlichkeit, Redlichkeit, Zuverlässigkeit, (3) Resultat, (4) Ansehen, Würde
腰掛け (こしかけ): (1) Sitz, Stuhl, Bank, Hocker, Schemel, Sessel, Sitzgelegenheit, (2) zeitweilige Arbeitsstelle
頂点 (ちょうてん): (1) Gipfel, Spitze, höchster Punkt, (2) Scheitelpunkt, (3) Vertex, Knoten, Knotenpunkt, (4) Höhepunkt, Klimax, Zenit, Kulmination
ビニール: Vinyl, Plastik, Kunststoff, aus Vinyl, Plastik…
水着 (みずぎ): Badeanzug, Badehose, Badebekleidung
お気の毒に (おきのどくに): traurigerweise
流域 (りゅういき): Becken (eines Flusses), Tal, Flussgebiet, Stromgebiet, Einzugsgebiet
出 (で): (1) Abstammung von …, Herkunft aus …, Ursprung aus …, (2) graduiert von …, (3) …‑Aufgang, (4) Fließen
瞼 (まぶた): Augenlid
必需品 (ひつじゅひん): Bedarfsartikel, notwendiger Artikel, notwendiger Gegenstand
温室 (おんしつ): (1) Treibhaus, Gewächshaus, (2) Bad, Badezimmer
意地悪 (いじわる): Boshaftigkeit, Bösartigkeit, Bosheit, Gemeinheit, boshaft, gemein
待ち合わせる (まちあわせる): sich verabreden, sich treffen, eine Zusammenkunft verabreden, zusammenkommen
就任 (しゅうにん): Amtsantritt, Amtübernahme, Einstand, ein Amt antreten
仕舞い (しまい): schlichter Nō-Tanz, Ende, Abschluss, Schluss
メーター: Zubin Mehta (ind. Dirigent; 1936–), (1) Messgerät, …Meter, (2) (mn) Meter (Zeichen: m)
請う (こう): bitten, anflehen, erbitten, ersuchen, flehen, betteln
特殊 (とくしゅ): Eigentümlichkeit, Eigenart, spezifisch, besonders, speziell, eigentümlich, charakteristisch, eigenartig, ausgeprägt, individuell
勝手に (かってに): (1) nach Belieben, aus eigener Bequemlichkeit, nach eigenem Gutdünken, (2) aus freiem Antrieb, aus freien Stücken, (3) ohne Erlaubnis, eigenmächtig, aus eigener Initiative, von selbst, (4) eigennützig, eigensüchtig
消防署 (しょうぼうしょ): Feuerwache, Feuerwehrstation
屍蝋 (しろう): Adipocire, Leichenwachs
余計 (よけい): (1) überflüssig, unnötig, unnütz, zuviel, zusätzlich, (2) mehr, viel, (1) zu viel, überschüssig, zusätzlich, unnütz, (2) viel, mehr, zu viel, überschüssig, zusätzlich, unnütz
直後 (ちょくご): gerade nach, unmittelbar nach, kurz nach, direkt hinter
儲ける (もうける): (1) verdienen, Gewinn bringen, gewinnen, erwerben, (2) bekommen, tragen
不運 (ふうん): Unglück, unglückliches Schicksal, Missgeschick, Pech, unglücklich, Unglücks…
分数 (ぶんすう): Bruch, Bruch…
擦る (こする): reiben, bürsten, schrubben, scheuern, bohnern, frottieren
通知 (つうち): Nachricht, Notiz, Mitteilung, Benachrichtigung, Information, Meldung, Anzeige, benachrichtigen, informieren, mitteilen, Bescheid geben, melden, berichten
謙虚 (けんきょ): Bescheidenheit, Zurückhaltung, Demut, bescheiden, demütig, zurückhaltend, in bescheidener Weise, demütig, zurückhaltend
ビルディング: großes Gebäude
理科 (りか): Naturwissenschaft, naturwissenschaftliche Abteilung
スクール: Schule
お目にかかる (おめにかかる): (1) sehen, empfangen, sprechen, zusammenkommen, (2) die Freude haben, zu sehen
不規則 (ふきそく): Unregelmäßigkeit, Ungeordnetheit, Unstetigkeit, unregelmäßig, regellos, ungeordnet, unstet
箒 (ほうき): Besen
実績 (じっせき): Erfolg, Leistung, Resultat, Ergebnis, Geschäft
往復 (おうふく): (1) Hin‑ und Rückweg, Hin‑ und Rückfahrt, Hin‑ und Rückflug, (2) Austausch von Briefen, (3) Rückfahrkarte, hin‑ und zurückgehen, hin‑ und zurückfahren, regelmäßig verkehren
交じる (まじる): (1) sich mischen, sich vermischen, vermischt sein, gemischt sein, (2) freundschaftlichen Umgang haben, verkehren, (3) hineindrängen, hineingehen
茂る (しげる): dicht wachsen, üppig wachsen, wuchern
溢れる (あふれる): (1) überlaufen, überfließen, hinaus strömen, sich ergießen, (2) wimmeln, soviele sein, dass sie nicht mehr hineinpassen, (3) in großer Menge vorhanden sein
防犯 (ぼうはん): Verbrechensverhütung, Verbrechensbekämpfung, Kriminalitätsprävention, Gefahrenabwehr
重たい (おもたい): (1) schwer, bleischwer, (2) schwerwiegend, ernst, ernsthaft, bedeutend, bedeutsam, wichtig, seriös, (3) niedergeschlagen, niedergedrückt, bedrückt, deprimiert, entmutigt
零点 (れいてん): (1) Null, nichts, (2) Nullpunkt, (3) null Punkte, (4) Nullstelle
算盤 (そろばん): (1) Soroban, Abakus, Rechenbrett, (2) Rechnung, Berechnung, (3) Rentabilität, Profitabilität
盗難 (とうなん): Diebstahl
案外 (あんがい): (1) Unerwartetheit, Überraschendheit, (2) Unhöflichkeit, (3) Unachtsamkeit, (4) unerwartet, wider Erwarten, überraschenderweise, überraschend, unerwartet, wider Erwarten
父母 (ふぼ): Vater und Mutter
頷く (うなずく): nicken, jmdm. zunicken, zustimmend nicken
オイル: Öl
流行る (はやる): (1) populär sein, Mode werden, in Mode sein, beliebt sein, (2) verbreitet sein, umgehen, um sich greifen, sich ausbreiten, wüten (Krankheit), (3) gedeihen, guten Zulauf haben, florieren
偏る (かたよる): (1) sich neigen, (2) einseitig sein, parteiisch sein
恨み (うらみ): (1) Groll, Ressentiment, Aufsässigkeit, Verbitterung, Hass, Rachegefühl, (2) Bedauern
騒々しい (そうぞうしい): (1) laut, lärmend, geräuschvoll, ohrenbetäubend, (2) unruhig, aufgeregt, stürmisch, turbulent
行事 (ぎょうじ): Ereignis, Fest, Veranstaltung, Begebenheit
教養 (きょうよう): (1) Erziehung, Ausbildung, (2) Bildung, Kultur, feine Lebensart, Kultiviertheit
塩辛い (しおからい): salzig, gesalzen, salzig schmeckend, zu salzig
うっかり: aus Zerstreutheit, aus Gedankenlosigkeit, aus Unvorsichtigkeit, ohne Absicht, ohne es zu wollen, unbewusst, aus Versehen, etw. ohne es zu wollen, tun, unvorsichtig handeln, versehentlich etw. machen
組み合わせ (くみあわせ): Zusammensetzung, Zusammenfügung, Kombination
容積 (ようせき): Kapazität, Volumen, Rauminhalt
迷う (まよう): (1) sich verirren, sich verlaufen, irregehen, vom rechten Pfad abkommen, (2) zögern, schwanken, sich nicht entscheiden können, verlegen sein, hilflos sein, ratlos sein, sich Kopfzerbrechen machen, (3) keine Ruhe finden können (eine Seele im Grab), (4) verliebt sein, vernarrt sein, bezaubert werden, betört werden
昼寝 (ひるね): Mittagsschlaf, Mittagsschläfchen
痺れる (しびれる): (1) einschlafen, gefühllos werden, gelähmt werden, (2) hingerissen sein, fasziniert sein, hin und weg sein
看板 (かんばん): (1) Schild, Aushängeschild, Reklameschild, Firmenschild, Büroschild, Plakat, (2) Ankündigungsschild (mit den Namen der Schauspieler und Programm etc.), (3) Attraktion, Aushängeschild, (4) Person, die eine Organisation oder Firma nach außen vertritt, (5) kurze Kleidung der Fußsoldaten und Diener mit eingefärbtem Familienwappen, (6) Geschäftsende einer Bar oder eines Restaurants, Sperrstunde, Poliziestunde, (7) öffentliches Eintreten für etw, (8) Kanban, Bestellbrett (Tafel bzw. Papierzettel mit den Bestellungen nach dem Kanban-System; in dieser Bedeutung häufig mit Kana geschrieben)
スタート: Start, starten
外部 (がいぶ): Außenwelt, Außenseite, Äußeres, äußere Welt, Oberfläche, äußerlich, außenstehend, Außen-
嵌める (はめる): (1) stecken, einfügen, einlegen, einsetzen, (2) anziehen, tragen (Ringe; Handschuhe etc.), (3) betrügen, täuschen, hinters Licht führen
自衛 (じえい): Selbstverteidigung, sich selbst verteidigen
田植え (たうえ): Reispflanzen, Auspflanzen von Reissetzlingen
素直 (すなお): (1) folgsam, gefügig, gehorsam, lieb, zahm, sanft, (2) ehrlich, offen, (3) einfach, aufrichtig, ungekünstelt, natürlich, echt, (4) leicht zu handhaben, unkompliziert, ohne Eigenheit, (5) gerade, nicht eingedreht, Unkompliziertheit, (1) gehorsam, willig, gelehrig, ehrlich, folgsam, naiv, (2) leicht zu handhaben, unkompliziert, gehorsam, ohne zu protestieren, ohne Widerstand, demütig
竹 (たけ): Bambus
資料 (しりょう): (1) Material, Stoff, Unterlagen, Daten, (2) Quelle
謙遜 (けんそん): Bescheidenheit, Zurückhaltung, Demut, Anspruchslosigkeit, bescheiden sein, zurückhaltend sein, anspruchslos sein, demütig sein, bescheiden, zurückhaltend, anspruchslos, demütig
お待ち遠様 (おまちどおさま): Entschuldigung, dass ich Sie habe warten lassen
習字 (しゅうじ): Schönschreiben, Schönschrift, Kalligraphie
給与 (きゅうよ): (1) Bezüge, Gehalt, Lohn, Besoldung, (2) Versorgung, Belieferung, Ration, versorgen, beliefern, rationieren
加速度 (かそくど): (1) Beschleunigung, (2) zunehmende Geschwindigkeit (einer Entwicklung)
継続 (けいぞく): (1) Fortsetzung, Fortdauer, Dauer, Erneuerung, Verlängern (z.B. Abonnement), (2) Nachfolge, Übernahme, fortdauern, dauern, fortsetzen, fortführen, verlängern
出勤 (しゅっきん): Dienstantritt, Anwesenheit, Zur-Arbeit-Gehen, Ins-Büro-Gehen, zum Dienst gehen, ins Büro gehen, in die Arbeit gehen
退く (どく): zur Seite rücken, zur Seite gehen, beiseite gehen, aus dem Weg gehen, Platz machen, Platz machen, aus dem Weg gehen
ちり紙 (ちりがみ): Papiertaschentücher, Toilettenpapier
凸凹 (でこぼこ): Unebenheit, (1) Unebenheit, Holprigkeit, (2) Unregelmäßigkeit, Unausgeglichenheit, holprig, uneben
半島 (はんとう): Halbinsel, Peninsula
撫でる (なでる): (1) streicheln, streichen, zärtlich über etw. hinwegfahren, reiben, (2) sanft kämmen
通帳 (つうちょう): Sparbuch, Kontobuch, Lebensmittelkarte
愈々 (いよいよ): (1) mehr und mehr, immer mehr, (2) endlich, schließlich, (3) sicher, gewiss, wirklich, tatsächlich
空 (くう): (1) Leere, Leerheit, Hohlheit, Vakuum, (2) Luft, Himmel, (3) Nichtigkeit, Eitelkeit, Vanität, Vergänglichkeit
基盤 (きばん): Fundament, Grundlage, Basis
磁石 (じしゃく): (1) Magnet, (2) Kompass (Abk.), (3) Magneteisenerz, Magnetit
副詞 (ふくし): Adverb
漁業 (ぎょぎょう): (1) Fischerei, Fischfang, (2) Fischfangindustrie
曲げる (まげる): (1) biegen, beugen, krumm machen, krümmen, neigen, (2) sich fügen, nachgeben, sich unterwerfen, verdrehen, entstellen, verfälschen, abweichen, abgehen
浴衣 (ゆかた): Yukata, Baumwoll-Sommerkimono
手洗い (てあらい): (1) Waschraum, Toilette, (2) Händewaschen
ペンチ: Zange
アクセント: (1) Akzent, Betonung, Tonfall, (2) Nachdruck, Gewicht, Betonung, (3) Akzent, kontrastierendes Detail
転がす (ころがす): rollen, ins Rollen bringen, wälzen, über den Haufen werfen, umstürzen, umwerfen, umkippen
合同 (ごうどう): (1) Vereinigung, Fusion, Einverleibung, Zusammenschluss, (2) Kongruenz (Zahlentheorie), sich vereinigen, sich verbinden, sich verschmelzen, fusionieren, kongruent, (1) gemeinsam, zusammen, (2) kongruent
バケツ: (1) Eimer, (2) Schaufelkammer, Schaufel (z.B. eines Wasserrades oder eines Baggers)
見本 (みほん): (1) Muster, Probe, Warenprobe, (2) Vorbild, Beispiel
合理 (ごうり): Vernunftmäßigkeit, Rationalität, Vernünftigkeit
鳴らす (ならす): (1) ertönen lassen, läuten, schlagen, (2) sich beschweren, sagen, (3) bekannt sein, berühmt sein
東洋 (とうよう): Ferner Osten, Morgenland, Orient, östliche Welt, Asien (besonders Ostasien), Morgenland, östlich, orientalisch, morgenländisch, asiatisch
蝋燭 (ろうそく): Kerze
正味 (しょうみ): (1) Netto…, (2) Nettogewicht, Nettopreis
作製 (さくせい): Anfertigung, Abfassung, Entwurf, Herstellung, Produktion, anfertigen, abfassen, entwerfen, produzieren, herstellen
各自 (かくじ): jeder, jedermann, ein jeder, alle, jeder einzelne, jedem
日課 (にっか): Tagespensum, tägliches Pensum, täglicher Arbeitsturnus, täglicher Geschäftsgang, Tagewerk
集金 (しゅうきん): Kassieren, Geldsammlung, Einziehung, kassieren, einkassieren, Geld sammeln, einziehen
溜まる (たまる): (1) sich ansammeln, sich anhäufen, stagnieren, (2) gespart werden, (3) im Rückstand sein
境界 (きょうかい): Grenze, Demarkation
街角 (まちかど): (1) Straßenecke, (2) Straße, (3) Straßenrand, Wegrand
能率 (のうりつ): (1) Leistungsfähigkeit, Effektivität, Effizienz, Ergiebigkeit, (2) Moment (Produkt aus zwei physikalischen Größen)
付近 (ふきん): Umgebung, Nachbarschaft, Nähe
人通り (ひとどおり): Verkehr, Fußgängerverkehr
焚く (たく): heizen, verbrennen, Feuer machen
フワフワ: (1) flaumig, flockig, leicht, weich, schwammig, (2) leichtfertig, unbeständig, unstet, unzuverlässig, leicht, luftig, schwebend, unbeständig, launisch, (1) flaumig, flockig, leicht, weich, schwammig, (2) leichtfertig, unbeständig, unstet, unzuverlässig
彫刻 (ちょうこく): (1) Bildhauerei, Schnitzerei, (2) Plastik, Skulptur, Statue, schnitzen, bildhauern, gravieren, ziselieren
ランチ: Barkasse, Mittagessen, Lunch
却って (かえって): (1) im Gegenteil, umgekehrt, (2) vielmehr, eher, lieber
標準 (ひょうじゅん): (1) Standard, Norm, Maßstab, Regel, Richtschnur, (2) Durchschnitt, Mittelmaß, (3) Niveau, Kriterium
構いません (かまいません): sich nicht kümmern
揃える (そろえる): (1) etw. gleich machen, anpassen, aufeinander abstimmen, in die gleiche Form bringen, in Übereinstimmung bringen, über einen Kamm scheren, (2) in einer Reihe nebeneinander stellen, (3) an einem Ort versammeln, (4) komplett haben, vervollständigen, ergänzen, (5) zusammenstellen, in Ordnung bringen, bereitlegen
跨ぐ (またぐ): schreiten, hinwegschreiten, überschreiten, hinübertreten, mit gespreizten Beinen stehen, rittlings sitzen
当日 (とうじつ): jener Tag, der betreffende Tag
肌着 (はだぎ): Unterwäsche
帳 (ちょう): (1) Vorhang (als Raumteiler), (2) Register, Eintragungsbuch, Verzeichnis, Album
突く (つく): (1) stoßen, schlagen, (2) stechen, (3) angreifen, (4) sich auf etw. stützen, (5) stechend riechen, (6) (dem Wetter) trotzen, (7) sagen, äußern, schimpfen
冷凍 (れいとう): Einfrieren, Tiefkühlung, einfrieren, gefrieren lassen, tiefkühlen
響く (ひびく): (1) schallen, erschallen, klingen, tönen, hallen, weit hörbar sein, (2) laut hörbar sein, (3) widerhallen, (4) mitschwingen, resonieren, (5) lange nachklingen, (6) Vibrationen verbreiten, erschüttern, (7) jmds. Ruhm verbreitet sich in die Welt, (8) schlechten Einfluss ausüben, wirken, beeinflussen, (9) Eindruck machen
言付ける (ことづける): eine Botschaft senden, benachrichtigen, jmdn. wissen lassen, jmdm. sagen lassen, jmdm. etw. zukommen lassen
飢える (うえる): (1) hungern, Hunger leiden, verhungern, (2) dürsten nach …, sich sehnen nach …, nach …begierig sein, hungern, Hunger leiden, verhungern
判子 (はんこ): Stempel, Namenssiegel
砕ける (くだける): (1) zerbrechen, zerbrochen werden, brechen, kaputt gehen, in Stücke gehen, zerfallen, zerschmettert werden, zerschellen, (2) freundlich werden, menschlich werden
生存 (せいぞん): (1) Dasein, Existenz, Leben, (2) Überleben, leben, da sein, existieren, überleben
船便 (ふなびん): Schiffspost, Post auf dem Seeweg
挟まる (はさまる): (1) eingeklemmt werden, eingezwickt werden, (2) zwischen etw. sein
期限 (きげん): (1) Termin, Frist, Zeitpunkt, Deadline, (2) Verjährungsfrist, Frist, Leistungszeit
番地 (ばんち): Hausnummer, Straßennummer
シーズン: (1) Saison, (2) Jahreszeit, (3) Spielsaison, in der Saison, Saison…
以後 (いご): (1) von nun an, in Zukunft, zukünftig, später, (2) seit …, von … an, ab …, nach ….
落とし物 (おとしもの): verlorene Sache, verlorener Gegenstand, Verlorenes, Fundsache
看病 (かんびょう): Krankenpflege, Krankenbetreuung, Wartung, einen Kranken pflegen, am Krankenbett wachen
蒸し暑い (むしあつい): schwül, feuchtwarm, drückend heiß
編む (あむ): (1) stricken, flechten, weben, häkeln, (2) zusammenstellen, herausgeben
回数 (かいすう): Häufigkeit, Frequenz
模試 (もし): (1) Probeexamen, Probeprüfung, Scheinprüfung, (2) Probeaufnahmeprüfung (Abk.)
清掃 (せいそう): Reinigung, Saubermachen, reinigen, sauber machen
先端 (せんたん): (1) Spitze, (2) Vorderfront (einer Entwicklung, Mode etc.)
研修 (けんしゅう): Studium, Schulung, Training, Ausbildung am Arbeitsplatz, Training on the Job (In-Service‑)Training, studieren, trainieren, sich schulen lassen
生年月日 (せいねんがっぴ): Geburtsdatum, Geburtstag und Geburtsjahr, geboren am …
ビタミン: Vitamin
縮む (ちぢむ): (1) einlaufen, eingehen, schrumpfen, sich verkürzen, sich zusammenziehen, (2) sich ducken, bescheiden sein, kleinlaut werden
商 (しょう): (1) Quotient, (2) Händler, Kaufmann, (3) Handel, Gewerbe, (4) Shang (älteste historisch belegte chin. Dynastie; ca. 16. Jhd. v.Chr. bis 1050 v.Chr.)
交ざる (まざる): vermischt sein, gemischt sein, sich mengen, sich vermischen, vermischt werden
休息 (きゅうそく): Pause, Atempause, Ruhepause, Ruhe, Rast, Rast (zehntes Lied aus dem Liederzyklus Die Winterreise von Franz Schubert; 1827), sich ausruhen, eine Pause machen, ausspannen
差し引き (さしひき): (1) Abzug, (2) Bilanz, Saldo, Überschuss, Rest, (3) Ebbe und Flut, Gezeiten
カバー: (1) Umschlag, Bezug, Überzug, Abdeckung, (2) Deckung (eines Betrages), decken, aufkommen für … (Ausgaben, Verlust etc.), (1) Umschlag, Bezug, Überzug, Abdeckung, (2) Deckung (eines Betrages)
一斉 (いっせい): Gleichzeitigkeit, Einstimmigkeit
お出掛け (おでかけ): Aufbruch, Fortgehen
塊 (かたまり): (1) Verklumpung, Klumpenbildung, (2) Klumpen, Stück, Masse, Haufen, Batzen, Kloß, Klümpchen, Knolle, (3) Gruppe, Schar, Herde, (4) extreme Neigung, (5) jmd mit extremer Neigung
言葉遣い (ことばづかい): Sprache, Ausdrucksweise
測定 (そくてい): Messung, messen, eine Messung durchführen
打ち消す (うちけす): verneinen, negieren, ableugnen, dementieren, in Abrede stellen
同格 (どうかく): (1) gleicher Rang, gleicher Status, (2) gleicher Fall, gleicher Kasus
未満 (みまん): unterhalb (einer best. Zahl)
断定 (だんてい): Schlussfolgerung, Entscheidung, Urteil, ein Urteil fällen, konstatieren
下書き (したがき): Konzept, Entwurf, Rohfassung, erste Niederschrift, unreine Fassung, das Unreine, Kladde, konzipieren, entwerfen, niederschreiben, ins Unreine schreiben
正門 (せいもん): Haupttor, Vordereingang
和 (わ): (1) Friede, (2) Harmonie, (3) Summe
撒く (まく): (1) ausstreuen, verstreuen, verteilen, besprengen, bestreuen mit, (2) jmdn. auf die falsche Spur bringen
オーバコート: Mantel, Überzieher
緩い (ゆるい): (1) lose, locker, (2) nachsichtig, mild, (3) weich, aufgeweicht, nicht fest, (4) langsam, (5) schwach, (6) sanft, schwach (ein Biegung), (7) schwunglos, (8) großherzig
目安 (めやす): Norm, Ziel, Maßstab
専制 (せんせい): Gewaltherrschaft, Willkürherrschaft, Despotie, Despotismus, Autokratie
近寄る (ちかよる): herankommen, sich nähern, näher kommen, in die Nähe kommen
複写 (ふくしゃ): Kopie, Vervielfältigung, Kopieren, kopieren, vervielfältigen
混ぜる (まぜる): (1) vermischen, vermengen, (2) beimischen, panschen, (3) einfügen, (4) umrühren, einrühren, (5) sagen, hinzufügen, (6) durch den Kakao ziehen
募集 (ぼしゅう): (1) Anwerbung, Suche (nach Arbeitskräften), Personaleinstellung, Stellenausschreibung, Ausschreibung, (2) Sammlung, Geldsammlung, (3) Begebung (von Anleihen), Zeichnung, Ausgabe, anwerben, werben, ausheben, rekrutieren,  (eine Stelle) ausschreiben
公表 (こうひょう): amtliche Bekanntmachung, öffentliche Bekanntmachung, Proklamation, Verkündigung, öffentlich bekannt geben, bekannt machen, veröffentlichen, verkündigen
正面 (しょうめん): Front, Vorderseite, Fassade, frontal
兼ねる (かねる): (1) gleichzeitig funktionieren als …, gleichzeitig dienen als …, zwei Funktionen haben, mit etw. verbunden sein, (2) zwei Ämter bekleiden, zwei Berufe ausüben, (3) sich zurückhalten, befangen sein, (4) für die Zukunft planen, (5) sich über lange Zeit erstrecken, sich über eine weite Entfernung erstrecken, (6) (als Suffix nach Ren’yōkei von Verben) … nicht recht können, es fällt einem schwer, … zu tun, (7) (in der Form … kanenai) vielleicht tun können
燃やす (もやす): verbrennen, anzünden, (1) verbrennen, anzünden, (2) brennen vor etw
南極 (なんきょく): Südpol, antarktisch
有難い (ありがたい): (1) dankenswert, dankwürdig, gnädig, gesegnet, willkommen, zusagend, (2) dankbar, erkenntlich
幼児 (ようじ): Kleinkind
替わる (かわる): (1) an jmds. Stelle treten, (2) sich abwechseln, (3) getauscht werden, abgelöst werden, eingelöst werden, (4) umgetauscht werden, sich ändern, wechseln
和服 (わふく): japanische Kleidung
慌ただしい (あわただしい): (1) gehetzt, rastlos, überstürzt, erregt, in Eile, (2) geschäftig
塞がる (ふさがる): (1) geschlossen werden, zugemacht werden, zugehen, sich verstopfen, (2) sich anfüllen, (3) besetzt sein, bewohnt sein, (4) sich schließen
スマート: (1) schlank, wohlproportioniert, schick, elegant, (2) smart, clever, geschickt, raffiniert, schlank, wohlproportioniert, schick, elegant, smart, clever, geschickt, raffiniert
レンズ: Linse, Objektiv
標識 (ひょうしき): Schild, Bake, Markierung, Zeichen
蒸気 (じょうき): Dampf
そう言えば (そういえば): übrigens, wo wir gerade darüber sprechen, da fällt mir gerade ein, apropos
拙い (つたない): ungeschickt, plump, unbeholfen
振り向く (ふりむく): (1) sich umwenden, sich umsehen, (2) beachten, zurückblicken
先祖 (せんぞ): Vorfahre, Ahne, Stammvater, angestammt, von den Vorfahren geerbt
お洒落 (おしゃれ): (1) Eleganz, Schickheit, Vornehmheit, (2) Schickimickitum, Dandytum, Stutzerhaftigkeit, Geckentum, (3) Schickmicki, Dandy, Stutzer, Modenarr, Modepuppe, Modedame (in den 1980er Jahren aufgekommener Begriff; früher sagte man shareta洒落た), (1) elegant, schick, modisch, stilvoll, fashionable, adrett, (2) Schickmicki…, gestylt, aufgebrezelt
帰す (かえす): heimschicken, nach Hause schicken, zurückkehren lassen, entlassen
滝 (たき): (1) Wasserfall, Katarakt, (2) Stromschnelle, Taki
合流 (ごうりゅう): Zusammenfluss, Konfluenz, Vereinigung, Zusammenströmen, Zulauf, zusammenfließen, ineinander fließen, sich vereinigen, sich anschließen
消化 (しょうか): Verdauung, Digerieren, verdauen, digerieren
応対 (おうたい): Empfang, Behandlung, empfangen, mit jmdm. umgehen, jmdn. behandeln, Gesellschaft leisten
加速 (かそく): Beschleunigung, beschleunigen
牧畜 (ぼくちく): Viehzucht
積む (つむ): (1) legen, stapeln, anhäufen, aufeinanderlegen, sammeln, (2) laden, beladen, (3) sich etw. durch Wiederholung verschaffen, (4) sparen, (5) hinlegen
崩す (くずす): (1) abbrechen, abtragen, niederreißen, zerstören, vernichten, (2) vereinfachen, (3) Geld wechseln, Geld klein machen
汚す (よごす): (1) schmutzig machen, beschmutzen, dreckig machen, besudeln, beflecken, (2) entehren, schänden, entweihen, entheiligen, (3) vergewaltigen, schänden (eine Frau), (4) in eine hohe Position aufsteigen (eine charakterlose oder unfähige Person), (5) anwesend sein, Mitglied sein (sehr bescheiden) etw. durch die eigene Anwesenheit Unehre machen, (1) schmutzig machen, beschmutzen, verschmutzen, verunreinigen (im Gegensatz zum Homographen kegasu meist im konkreten Sinn benutzt), (2) Aemono machen, einen gemischten Salat machen
針路 (しんろ): Kurs (eines Schiffes oder Flugzeuges)
歌謡 (かよう): (1) Reimprosa, (2) Lied in Versform, musikalisch begleiteter Text, Gesang, (3) Ballade
損得 (そんとく): Verlust und Gewinn, Verlust oder Gewinn
ぶつぶつ: (1) Meckern, Murren, Nörgeln, (2) Pickel, Akne, Hautausschlag, (1) in kleine Stücke, (2) köchelnd, (3) mit vielen kleinen Dellen, mit vielen kleinen Löchern
サラリーマン: Angestellter, Büroangestellter
問答 (もんどう): (1) Frage und Antwort, Dialog, (2) Diskussion, (3) Unterweisung im Katechismus, fragen und antworten
作者 (さくしゃ): (1) Autor, Verfasser, (2) Künstler
話しかける (はなしかける): (1) ansprechen, anreden, das Wort richten an, (2) sprechen wollen
植木 (うえき): Gartenpflanze, Topfpflanze, Ueki
どうせ: (1) sowieso, auf jeden Fall, immerhin, irgendwie, (2) am Ende, im Grunde, schließlich, (3) im besten Fall
暴れる (あばれる): wüten, toben, Radau machen, randalieren, rasen, gewalttätig sein
落第 (らくだい): (1) Durchfallen in einer Prüfung, (2) Sitzenbleiben, in einer Prüfung durchfallen
稽古 (けいこ): (1) Übung, Training, (2) Unterricht, Schulung, (3) Einstudieren, Probe, (1) üben, trainieren, sich schulen in …, (2) einstudieren, proben, eine Probe abhalten
方角 (ほうがく): (1) Himmelsrichtung, (2) Richtung, Orientierung
湿度 (しつど): Feuchtigkeit, Luftfeuchtigkeit
アイデア: Idee
重役 (じゅうやく): Direktor, Vorstand, Geschäftsleitung, Vorstandsmitglied
諄い (くどい): (1) weitschweifig, wortreich, langweilig, geschwätzig, (2) schwer, fettig, (3) aufdringlich, laut, penetrant, grell
別荘 (べっそう): Wochenendhaus, Ferienhaus, Sommerhaus, Landhaus
レインコート: Regenmantel, Regenmantel, Regenjacke
私立 (しりつ): privater Besitz, privat (die korrekte Aussprache der Zeichen ist shiritsudas ist jedoch Homonym zu shiritsu = städtischdeshalb wird wegen der Eindeutigkeit manchmal diese Aussprache benutzt), privat, Privat…, nicht öffentlich
スチュワーデス: Stewardess, Flugbegleiterin
まごまご: verwirrt, durcheinander, unschlüssig, unentschlossen, zögerlich, sich nicht zurecht finden, verwirrt sein, durcheinander sein, unschlüssig sein, unentschlossen sein, zögerlich sein
評論 (ひょうろん): Kritik, Besprechung, Rezension, Leitartikel, Zeitkritik, Kommentar, kritisieren, besprechen, rezensieren
噴火 (ふんか): Vulkanausbruch, Eruption, ausbrechen, tätig sein, aktiv sein (Vulkan)
脅かす (おどかす): (1) bedrohen, einschüchtern, erpressen, (2) erschrecken, überraschen
炊事 (すいじ): das Kochen, kochen
コック: Hahn, Zapfen, Koch, Küchenmeister
小指 (こゆび): (1) kleiner Finger, kleine Zehe, (2) Ehefrau, Geliebte
産 (さん): (1) Geburt, (2) Produktion, (3) Herkunft, (4) Vermögen
目茶苦茶 (めちゃくちゃ): Durcheinander, Tohuwabohu, Chaos
五十音 (ごじゅうおん): die fünfzig grundlegenden Silbenlaute im Japanischen (es sind eigentl. nur 47 bzw. 45 Laute – zumal das n ん eine Sonderrolle spielt – aber die fünfzig passt besser zur entsprechenden Matrix; siehe gujūon-zu五十音図)
彼方 (かなた): dort, drüben, da, dort in der Ferne
全身 (ぜんしん): der ganze Körper, am ganzen Körper
モノレール: Monorail, Einschienenbahn
ウェイトレス: Kellnerin
捻る (ひねる): (1) drehen, umdrehen, sich drehen, wälzen, (2) biegen, (3) schlagen, fertig machen, besiegen, (4) ausbrüten, ausarbeiten
縞 (しま): Streifen, Band, Markierung, gestreift
貨物 (かもつ): (1) Güter, Waren, Fracht, Frachtgut, Last, Ladung, (2) materielle Güter
信ずる (しんずる): (1) glauben, Glauben schenken, für richtig halten, sicher sein, (2) glauben (Religion), (3) vertrauen, Vertrauen schenken, Vertrauen haben
井戸 (いど): (1) Brunnen, (2) Ido・chawan (um 1600 in Korea hergestellte Teeschale mit dünner gelblich-oranger Glasur; wird von Anhängern der Teezeremonie überaus geschätzt; Abk.)
区域 (くいき): Bezirk, Bereich, Zone
ハンドル: (1) Türknopf, Türklinke, (2) Steuerrad, Lenkrad, Lenkstange, Lenker, (3) Handle
密 (みつ): Dichte, Enge, Präzision, Feinheit, dicht, eng, dick, genau, präzise, vorsichtig, fein
孝行 (こうこう): (1) Liebe zu den Eltern, Kindespflicht, kindliche Pietät gegenüber den Eltern, (2) Achtung, Hochachtung, Sorge
焦がす (こがす): (1) anbrennen, anbrennen lassen, versengen, verbrennen lassen, (2) sich verzehren, sich sehnen
敬語 (けいご): höflicher Ausdruck, Höflichkeitsform, Höflichkeitssprache
吊る (つる): (1) aufhängen, hängend anbringen, (2) bauen, (3) hochheben, tragen, (4) nach oben ziehen, (5) in Falten legen
貸家 (かしや): Miethaus
寿命 (じゅみょう):  (natürliche)Lebensdauer, Leben, Lebensspanne
編み物 (あみもの): (1) Strickerei, Stricken, Häkeln, (2) Strickware, Strickarbeit, Häkelarbeit
終了 (しゅうりょう): (1) Schluss, Ende, Abschluss, (2) Beendigung (z.B. eines Programms), abschließen, beenden, vollenden, fertig werden, vollenden
ステージ: Bühne
梯子 (はしご): (1) Leiter, (2) Treppe, (3) Kneipentour, Kneipenbummel, Sauftour
強化 (きょうか): (1) Stärkung, Verstärkung, Intensivierung, (2) Reinforcement, Verstärkung, Bekräftigung, stärken, intensivieren, aufbauen, ausbauen (eine Position)
サークル: (1) Arbeitsgruppe, Gruppe, Klub, Zirkel, (2) Kreis, Sphäre
過程 (かてい): Prozess, Verlauf
初旬 (しょじゅん): erste Monatsdekade, Anfang eines Monats
貯蔵 (ちょぞう): Lagerung, Aufbewahrung, Vorrat, lagern, einlagern, aufspeichern, aufbewahren, einmachen
統一 (とういつ): Einheit, Einheitlichkeit, Vereinheitlichung, Vereinigung, vereinheitlichen, vereinigen
若々しい (わかわかしい): jugendfrisch, taufrisch, jugendlich, blühend, frisch und jung
小学生 (しょうがくせい): Grundschüler
矢印 (やじるし): Richtungspfeil, Pfeil
後輩 (こうはい): (1) jüngerer Kollege, jüngerer Mitschüler, jüngerer Kommilitone, später Angestellter, Junior, später eingetretener Mitschüler oder Kollege, (2) Nachwuchs, jüngere Generation, Nachgeborener
延長 (えんちょう): (1) Verlängerung, Ausdehnung, Dehnung, Erweiterung, (2) Verlängerung einer Strecke, (3) Gesamtlänge, (4) Ausdehnung eines Körpers, Ausmaß, (5) Extension, Enchō (Ärabez.: 11.4.923–26.4.931), verlängern, ausdehnen
お代わり (おかわり): eine weitere Portion, Nachschlag, ein weiteres Glas (von etw. was man gerade isst od. trinkt)
接続 (せつぞく): Verbindung, Verknüpfung, Anschluss, verbinden, verknüpfen
名刺 (めいし): Visitenkarte
外科 (げか): (1) Chirurgie, (2) chirurgische Abteilung, Abteilung für Chirurgie, Chirurgie
針金 (はりがね): Draht
実る (みのる): (1) Früchte tragen, reifen, (2) Ergebnisse bringen
せっせと: fleißig, emsig
どっと: (1) plötzlich, jäh, unerwartet, überraschend, (2) auf einmal, in Massen, (3) mit Ungestüm
敬う (うやまう): respektieren, Respekt erweisen, verehren, ehren, in Ehren halten, achten
羨ましい (うらやましい): beneidenswert, beneidenswürdig, zu beneiden sein
赤道 (せきどう): Äquator, äquatorial
定員 (ていいん): (1) zugelassene Personenzahl, festgesetzte Personenzahl, Aufnahmekapazität, Höchstzahl, (2) Gesamtzahl, Kopfstärke, Vollzähligkeit
呼びかける (よびかける): (1) anrufen, anreden, ansprechen, (2) appellieren
卸す (おろす): en gros verkaufen, zum Großhandelspreis verkaufen
ガム: (mn) Kaugummi
蒸発 (じょうはつ): (1) Verdampfen, Verdunstung, Evaporation, (2) geheimnisvolles Verschwinden, (1) verdampfen, verdunsten, evaporieren, (2) verschwinden, (3) weglaufen
落ち着く (おちつく): (1) sich beruhigen, ruhig werden, nachlassen, zur Ruhe kommen, den Kopf behalten, (2) sich niederlassen, sich einrichten, sesshaft werden, Wohnung nehmen, (3) sich zusammennehmen, sich zusammenreißen, (4) sich entscheiden für …
製作 (せいさく): Herstellung, Anfertigung, Erzeugung, Produktion, Fabrikation, Fertigung, herstellen, anfertigen, erzeugen, fabrizieren, fertigen
命ずる (めいずる): (1) befehlen, anordnen, einen Befehl erteilen, (2) ernennen, berufen
北極 (ほっきょく): Nordpol, arktisch
ストッキング: Strümpfe
灯 (ひ): Licht, Licht, Lampe, Lampenlicht, Licht
送別 (そうべつ): Verabschiedung, Abschied
埋める (うめる): (1) begraben, beerdigen, vergraben, (2) zuschütten, füllen, ausfüllen, zustopfen, plombieren, (3) decken, (4) Wasser zugießen
削除 (さくじょ): (1) Streichung, (2) Löschen, Streichen, Ausstreichen, Weglassen, Eliminieren, löschen, streichen, ausstreichen, weglassen, eliminieren
何々 (なになに): (1) so und so, (2) nun, lassen Sie mal sehen (wenn man eine schwer zu beantwortende Frage gestellt bekommt)
順々 (じゅんじゅん): Reihenfolge
四つ角 (よつかど): Kreuzung, Straßenecke
羊毛 (ようもう): Schafwolle, wollen, aus Wolle
薄暗い (うすぐらい): halbdunkel, dämmrig
再三 (さいさん): (1) mehrere Male, (2) wiederholt, mehrmals, wieder und wieder, immer wieder
平気 (へいき): Gleichgültigkeit, Gelassenheit, Ungerührtheit, Nonchalance, Kälte, Schamlosigkeit, gleichgültig, gelassen, ungerührt, nonchalant, kalt, schamlos
消極的 (しょうきょくてき): negativ, passiv, konservativ
職人 (しょくにん): Handwerker, Arbeiter, Geselle
部 (ぶ): (1) (2) 
見慣れる (みなれる): (1) sich an einen Anblick gewöhnen, (2) (mit jmdm.) vertraut werden, sich gewöhnen
憧れる (あこがれる): (1) sich sehnen, Sehnsucht haben, schmachten, streben nach …, (2) verehren, anbeten, bewundern
本の (ほんの): nur ein bisschen, nur, bloß, klein, leicht, nichts als
枚数 (まいすう): Zahl der Blätter, Zahl der Bögen
発条 (ばね): Feder, Triebfeder, Unruhe, Spiralfeder, Feder, Spiralfeder, Sprungfeder, Springfeder, Triebfeder, (1) Feder, Schraubenfeder, (2) Triebfeder, Unruhe, Spiralfeder, Spiralfeder, Sprungfeder
水素 (すいそ): Wasserstoff, Hydrogen, Hydrogenium (farb‑, geruchloses u. geschmackfreies Gas; Zeichen: H)
オーケストラ: Orchester
分類 (ぶんるい): Einteilung, Anordnung, Klassifikation, Klassifizierung, System, klassifizieren, in Klassen einteilen, einteilen, ordnen, systematisieren, sortieren, passend zusammenstellen
遣っ付ける (やっつける): (1) etw. durchführen, ohne an die Folgen zu denken, (2) jmdn. fertig machen, (3) angreifen, kritisieren
角度 (かくど): (1) Größe eines Winkels, Winkel, (2) Blickwinkel, Gesichtspunkt, Standpunkt
下らない (くだらない): (1) albern, blöde, dumm, töricht, unsinnig, (2) nutzlos, unnütz, fruchtlos, nichtig, (3) unbedeutend, unwichtig, belanglos, geringfügig
縮れる (ちぢれる): sich kräuseln, sich locken, sich wellen
引っ込む (ひっこむ): (1) sich zurückziehen, (2) einsinken, einfallen, (3) zögern, sich zurückhalten
顕微鏡 (けんびきょう): Mikroskop
短期 (たんき): kurze Zeit, kurzzeitig, kurzfristig, zeitweilig
輸血 (ゆけつ): Bluttransfusion, eine Bluttransfusion geben, Blut übertragen
団地 (だんち): (1) Gebiet mit planmäßig angelegten Wohnungsblocks und Fabriken, für ein Gebiet planmäßig angelegte Wohnungsblocks und Fabriken, (2) (insbes.)Danchi, Wohnsiedlung, Siedlung, Siedlungsgelände
身分 (みぶん): (1) soziale Stellung, Stand, (2) Rang, (3) Herkunft, Identität
直流 (ちょくりゅう): Gleichstrom
抽象 (ちゅうしょう): Abstraktion, Abstrahieren
汲む (くむ): (1) schöpfen, ausschöpfen, auskellen, (2) verstehen, sich bewusst sein, Rücksicht nehmen, sich in jmds. Lage versetzen, etw. nachfühlen, (3) abstammen von …, hervorgehen aus …, … nachfolgen
広める (ひろめる): (1) verbreitern, erweitern, ausweiten, (2) verbreiten, allgemeine bekannt machen, in allgemeinen Gebrauch bringen
ウーマン: Frau
望遠鏡 (ぼうえんきょう): Fernrohr, Teleskop
黴 (かび): Schimmel
ブラウス: Bluse
テーマ: Thema
お帰り (おかえり): Heimkehr
眩しい (まぶしい): blendend, blendend hell, grell
争う (あらそう): (1) streiten, sich zanken, Streit haben, uneinig sein, (2) kämpfen, wetteifern, ringen, konkurrieren, (3) leugnen (mit Verneinung)
方針 (ほうしん): (1) Kompassnadel, (2) Prinzip, Grundsatz, Richtlinie, Richtschnur, (3) Kurs, Politik, Absicht, Ziel, (4) Zielsetzung, Programm, Plan, Vorhaben
形式 (けいしき): (1) Form, Formsache, Formalität, (2) äußere Form
サンプル: Stichprobe, Sample
限り (かぎり): Grenze, Einschränkung, Beschränkung
長 (ちょう): (1) Direktor, Chef, Leiter, (2) der starke Punkt, Vorteil, (3) Dur (Abk.)
回数券 (かいすうけん): Sammelfahrkarte, Mehrfahrtenkarte (z.B. für Eintritt, Transport oder Essen)
耐える (たえる): (1) ertragen, erdulden, aushalten, überstehen, ausstehen, ausharren, (2) widerstehen, standhalten, tauglich sein, halten, (3) gewachsen sein (einer Bürde, einer Aufgabe), (4) etw. Wert sein, (5) hervorragen, hervorragend sein
包帯 (ほうたい): Verband
ぎっしり: genau passend, ohne Lücke, dicht, gedrängt, voll
薬指 (くすりゆび): Ringfinger
知人 (ちじん): Bekannter, Bekannte, Freund, Freundin
浮く (うく): (1) schwimmen, treiben, schweben, auftauchen, wieder flott werden, (2) auf die Nerven fallen, (3) locker sein, wackelig sein, (4) sparen, übrigbehalten, Geld herausbekommen
大 (だい): (1) groß, (2) hervorragend, laut, weit, stark, (3) lang (Monat), Taishō (Ärabez.: 30.7.1912–25.12.1926)
勿体ない (もったいない): (1) zu schade, zu gut, (2) profan, respektlos, pietätlos
漸く (ようやく): (1) endlich, schließlich, (2) allmählich, langsam, nach und nach, (3) mit knapper Not, nur mühsam
売り切れ (うりきれ): Ausverkauft! (Schildaufschrift), Ausgehen, Ausverkauft-Sein, ausverkauft
子孫 (しそん): Nachkomme, Nachfahre, Nachkommenschaft, Abkömmlinge, Kindeskinder, Nachwelt
出入り口 (でいりぐち): Aus- und Eingang, Eingang, Zugang, Torweg
絞る (しぼる): (1) auswringen, ausdrücken, wringen, (2) pressen, auspressen, (3) eine Kuh melken, (4) sich den Kopf zerbrechen, (5) abblenden (Licht), (6) einschränken, reduzieren
千切る (ちぎる): zerreißen, auseinanderreißen, in Stücke reißen, gewaltsam in Teile trennen
蓋 (ふた): Deckel, Haube, Verschluss, Klappe
隙 (すき): (1) Lücke, Spalt, Öffnung, freier Raum, (2) günstige Gelegenheit, Chance, Platz, (3) Blöße
零れる (こぼれる): (1) daneben fallen, herunterfallen, verschüttet werden, (2) überfließen, übergehen, hinunterlaufen, herauslaufen
高度 (こうど): (1) Höhe, Höhe über dem Meer, (2) Hochgradigkeit, vorgerückte Stufe, (1) hoch, hoch gelegen, (2) hoch entwickelt, hochgradig, hochgradig, hochgradig, hochentwickelt, stark
繋げる (つなげる): verbinden, verknüpfen
マンション: Apartment, Apartmenthaus, Etagenhaus
酒場 (さかば): Lokal, Kneipe, Bar, Schenke, Taverne
照らす (てらす): (1) scheinen, bescheinen, beleuchten, Licht werfen, (2) vergleichen, abgleichen, gegenüberstellen
生長 (せいちょう): Wachstum, Wachsen, Wuchs, Entwicklung (wachsen und herangezogen werden; insbes. für Pflanzen benutzt)
バック: (1) Hintergrund, (2) hinten, (3) Unterstützung, (4) Unterstützer, (5) Rückwärtsgehen, Rückwärtsfahren, (6) Rückgabe, (7) Verteidiger, (8) Rückenschlag, Rückenschwimmen, (9) Rückhand, Backhand, Pearl S. Buck (amerik. Schriftstellerin; 1892–1973; verbrachte lange Zeit in Chinabeschreibt v.a. chin. Alltagslebens), rückwärts fahren
蹴る (ける): (1) treten, kicken, mit dem Fuß stoßen, (2) abschlagen (z.B. eine Bitte)
毛糸 (けいと): Wolle, Wollgarn, Wollfaden, Strickwolle
拝む (おがむ): (1) anbeten, beten, verehren, (2) verehrend betrachten, andächtig betrachten
友好 (ゆうこう): Freundschaft
論 (ろん): (1) Argument, Beweisführung, Argumentation, Diskussion, Erörterung, Debatte, Disput, Bemerkung, (2) Abhandlung, Dissertation, Essay, (3) Meinung, Ansicht, (4) Frage, Problem
神話 (しんわ): Mythos, Göttersage, mythisch
出来上がる (できあがる): (1) fertig sein, fertig werden, vollendet sein, fertig gestellt sein, (2) betrunken sein
干す (ほす): (1) trocknen, austrocknen, (2) trockenlegen, (3) austrinken, (4) jmdm. den Lebensunterhalt rauben
免税 (めんぜい): Steuerbefreiung, Steuererlass, Zollbefreiung, steuerfrei
クーラー: (1) Klimaanlage, (2) Weinkühler
用途 (ようと): Verwendungszweck, Verwendungsmöglichkeit, Verwendung, Gebrauch, Benutzung
返る (かえる): zurückkehren (in den ursprünglichen Zustand), zurückkommen, zurückgegeben werden, rückgängig machen
彼此 (あれこれ): dies und das
高 (こう): (1) hoch, Höhe, (2) groß, hoch (z.B. eine Summe), (3) edel, erhaben, (4) stolz, hochmütig, (5) verehrt, Ihr (für z.B. Handlungen einer anderen Person), (6) Oberschule, Kō
対策 (たいさく): Gegenmaßnahme, Maßnahme
重力 (じゅうりょく): (1) Schwerkraft, Gravitation, (2) große Kraft
隙間 (すきま): Lücke, Spalt, Nische, Öffnung, Zwischenraum, freier Raum
海水浴 (かいすいよく): Seebad, Baden in der See
潰す (つぶす): (1) zerdrücken, zerquetschen, zertreten, erschlagen, (2) ruinieren, kaputt machen, zunichte machen, (3) totschlagen, verbringen (Zeit), (4) totschlagen, (5) verschrotten, einschmelzen, einstampfen
解く (ほどく): aufmachen, aufschnüren, aufbinden
四捨五入 (ししゃごにゅう): Runden von Bruchzahlen (bis vier abrunden und ab fünf aufrunden), runden
言いつける (いいつける): (1) anweisen, anleiten, anordnen, bestellen, heißen, (2) anzeigen, denunzieren, petzen
述語 (じゅつご): Prädikat
揉む (もむ): (1) reiben, (2) zerknüllen, (3) massieren, (4) diskutieren
順序 (じゅんじょ): (1) Ordnung, Reihenfolge, (2) geordnetes Verfahren, Methode, System
占う (うらなう): wahrsagen
利害 (りがい): Vor‑ und Nachteile, Für und Wider, Interesse, Belang
炙る (あぶる): (1) rösten, anrösten, (2) wärmen, (3) am Feuer trocknen
日程 (にってい): (1) Tagesprogramm, Stundenplan, (2) Tagesordnung
混合 (こんごう): Mischung, Vermischung, Gemisch, mischen
権 (けん): (1) Macht, Einfluss, (2) Autorität, Befugnis, (3) List, Kunstgriff, (4) Stolz, Hochmut, (5) Schärfe (des Blickes od. des Tones), Kälte des Blickes od. des Tones
険しい (けわしい): (1) steil, abschüssig, ansteigend, schroff, (2) schwierig, anspruchsvoll, anstrengend, mühsam, (3) hart, streng, finster, düster, trübe, scharf, (4) unnahbar, (5) gehetzt, beschäftigt
表紙 (ひょうし): Buchdeckel, Deckel, Einband
口実 (こうじつ): (1) Ausflucht, Vorwand, Ausrede, (2) falsche Beschuldigung, (3) Redeweise, häufig im Mund geführtes Wort
調整 (ちょうせい): Regelung, Ausgleich, Anordnung, Modulation, Regulierung, Richtigstellen, anpassen, einstellen, justieren, regulieren, in Ordnung bringen
定休日 (ていきゅうび):  (regelmäßiger)Ruhetag
文脈 (ぶんみゃく): Kontext, Zusammenhang, Gedankengang
親指 (おやゆび): Daumen, große Zehe
為す (なす): tun, machen, durchführen, versuchen, vollbringen, vollenden, (1) erreichen, vollbringen, (2) tun, bilden
児童 (じどう): Kind, Jungen und Mädchen, Schulkind
モダン: Moderne, modern
心得る (こころえる): (1) wissen, kennen, verstehen, (2) betrachten als …, halten für …
引き受ける (ひきうける): übernehmen, entgegennehmen, auf sich nehmen, akzeptieren, garantieren, zustimmen
目上 (めうえ): Vorgesetzter, Ranghöherer, Höherstehender, Älterer
薬缶 (やかん): Kessel, Wasserkessel, Teekessel
遊園地 (ゆうえんち): Spielplatz, Rummelplatz, Vergnügungspark
元日 (がんじつ): Neujahr, Neujahrstag, 1. Januar
方面 (ほうめん): (1) Richtung, Seite, Gebiet, (2) Gebiet
日差し (ひざし): Sonnenschein, Sonnenstrahlen, Sonnenlicht
儀式 (ぎしき): (1) Zeremonie, Feierlichkeit, Festlichkeit, Ritual, Ritus, (2) Etikette bei Angelegenheiten und Zeremonien bei Hofe, zeremoniell
釜 (かま): Kessel, Kochtopf, Reistopf
測量 (そくりょう): Messung, Vermessung, messen, vermessen
噴水 (ふんすい): Springbrunnen, Fontäne
重体 (じゅうたい): kritischer Zustand, Lebensgefahr
電池 (でんち): Batterie
受話器 (じゅわき): Telefonhörer, Hörer
羽 (わ): Zählwort für Vögel und kleine Tiere (an chin. Lesung von Zahlen suffigiert; 1=ichiwa; 3=sanwa, sanba; 6=rokuwa, roppa; 10=jūwa, jippa, juppa)
何となく (なんとなく): (1) irgendwie, der Himmel weiß wie, (2) völlig, ganz, gesamt, irgendwie, der Himmel weiß wie
乾燥 (かんそう): (1) Trockenheit, (2) Austrocknen, (3) Langweiligkeit, Geschmacklosigkeit, (1) trocknen, (2) austrocknen, trocken werden
下水 (げすい): (1) Abwasser, (2) Kanalisation, Abwasserkanal, Abwasserleitung (Abk. für gesui・dō 下水道)
年度 (ねんど): Jahr, Jahrgang, Steuerjahr, Haushaltsjahr, Etatjahr, Geschäftsjahr, Schuljahr, Rechnungsjahr, Regierungsperiode
耕す (たがやす): pflügen, bestellen (den Boden), bebauen
標本 (ひょうほん): (1) Exemplar, Muster, (2) Typus, Beispiel, (3) Präparat, Probe, Probeexemplar, Untersuchungsgruppe
記号 (きごう): (1) Zeichen, Symbol, Emblem, Ideogramm, (2) (insbes.)Notenschlüssel, (3) Wahrzeichen, (4) Zeichen,  (franz.)signe (in der Linguistik Ferdinand de Saussures)
お早う (おはよう): Guten Morgen! (wörtl. es ist früh!; wird deshalb auch verwendet, wenn man nicht erwartet, dass der andere auch schon so früh dran ist; Bardamen, die zur Nachtschicht antreten sagen deshalb evtl. auch o・hayō)
器具 (きぐ): Gerät, Werkzeug, Instrument, Geschirr, Utensilien
飽くまで (あくまで): (1) bis zum Äußersten, beharrlich, hartnäckig, unentwegt, unter allen Umständen, (2) so gut man kann, (3) beharrlich, (4) durchaus
フライパン: Bratpfanne
増減 (ぞうげん): (1) Zunahme und Abnahme, Fluktuation, (2) Zunahme oder Abnahme, (1) zunehmen und abnehmen, fluktuieren, (2) zunehmen oder abnehmen
寄越す (よこす): (1) schicken, abschicken, (2) geben, liefern, übergeben, (3) jmd kommen lassen, (4) mitteilen
推定 (すいてい): Vermutung, Folgerung, Schlussfolgerung, Annahme, Mutmaßung, schätzen, schließen
巻く (まく): (1) einwickeln, umwickeln, herumlegen, (2) zusammenrollen, aufrollen, aufwickeln, (3) aufziehen (z.B. eine Feder od. eine Uhr), (4) drehen, wirbeln, strudeln, (5) umgeben, (6) umgehen, (7) kreisen, sich drehen, rollen, (8) sich in einer Spiralform bewegen, (9) schwer atmen, keuchen
呼び出す (よびだす): (1) jmdn. zu sich rufen, jmdn. rufen und kommen lassen, jmdn. ausrufen, jmdn. laden, jmdn. vorladen, jmdn. zitieren, jmdn. ans Telefon rufen, (2) jmdn. herausrufen, (3) aufrufen (z.B. eine Subroutine)
訳す (やくす): übersetzen
ウール: Wolle
侵入 (しんにゅう): (1) Einfall, Einmarschieren, Invasion, Eindringen, Einbruch, (2) unbefugtes Betreten, (3) Eindringen, Penetration, Intrusion, einmarschieren, einziehen
絶えず (たえず): ununterbrochen, ständig, ohne Unterbrechung, immer, unaufhörlich, dauernd
苦心 (くしん): Bemühung, Mühe, Plage, Anstrengung, Bestreben, Schufterei, harte Arbeit, Kopfzerbrechen, Sorge, sich bemühen, sich Mühe geben, sich anstrengen, sich abplacken, ringen, sich Sorgen machen, sich sorgen, sich den Kopf zerbrechen, grübeln, angestrengt nachdenken
超過 (ちょうか): Überschuss, Überschreitung, überschießen, mehr betragen, hinausgehen, überschreiten, übersteigen
大人しい (おとなしい): (1) sanft, gut, artig, wohlerzogen, gehorsam, sanftmütig, zurückhaltend, dezent, (2) zahm, (3) dezent, ruhig, nüchtern
通路 (つうろ): Durchgang, Passage
養分 (ようぶん): Nahrung, Nahrungsstoff
果たして (はたして): (1) wie erwartet, wie vermutet, wie ich gedacht habe, (2) tatsächlich, in der Tat, wirklich
透き通る (すきとおる): transparent sein, durchsichtig sein, durchscheinend sein, klar sein
強引 (ごういん): Brutalität, Gewalt, brutal, gewaltsam, mit Gewalt, gewaltsam, mit Zwang, brutal
破れる (やぶれる): (1) zerreißen, zerbrechen, (2) misslingen, missglücken
鑑賞 (かんしょう): Würdigung, Wertschätzung, Verständnis, Genuss, genießen, würdigen, schätzen, wertschätzen
缶詰 (かんづめ): (1) Konserve, Dose, Konservendose, Konservenbüchse, (2) Einschluss, Einsperrung
過剰 (かじょう): (1) (2) , überschüssig, exzessiv
満員 (まんいん): (1) Überfüllung, Ausgebucht-Sein, Vollbesetztheit, (2) Ausverkauft!, (3) Besetzt!, (4) Überfüllt!, voll, voll besetzt, überfüllt, ausgebucht
車掌 (しゃしょう): Schaffner, Zugführer
工夫 (くふう): (1) gründliches Überlegen über das beste Mittel, gründliche Planung, (2) Mittel, Maßnahme, Plan, Idee, Entwurf, (3) tiefes Studium, Askese, (4) Nachdenken über ein Kōan, erfinden, ersinnen, ausdenken, erdenken, aushecken, planen, entwerfen, Pläne machen
古典 (こてん): (1) klassisches Werk, Klassiker, (2) Klassik, (3) klassische Literatur, klassische Dichtung, klassisch
瓦 (かわら): Dachziegel, Ziegel
下町 (したまち): (1) Unterstadt, tiefergelegene Stadtteile, (2) Geschäftsviertel, Shitamachi (Unterstadt von Tōkyō; die Viertel Taitō, Chiyoda, Chūō und östlich des Sumida-Flusses)
人命 (じんめい): Menschenleben, menschliches Leben
大通り (おおどおり): breite Straße, Hauptstraße, Boulevard, Avenue
桁 (けた): (1) Tragbalken, Träger, Querbalken, Sparren, Brückenbalken, Spiere, Holm, (2) Stelle (einer Zahl)
円周 (えんしゅう): Kreisumfang, Peripherie
長女 (ちょうじょ): älteste Tochter, erstgeborene Tochter
網 (あみ): (1) Netz, (2) Falle
溶かす (とかす): auflösen, lösen, schmelzen
仕上がる (しあがる): fertig machen, fertig stellen, vollenden, beenden
錆 (さび): Rost
映る (うつる): (1) sich spiegeln, sich widerspiegeln, Schatten werfen, reflektieren, (2) fotografiert werden, gefilmt werden, aufgenommen werden, aufs Bild kommen, (3) passen, harmonisieren, zusammen passen, (4) gut stehen
破片 (はへん): Splitter, Bruchstück
憎らしい (にくらしい): unausstehlich, gehässig, hassenswert, verabscheuungswürdig
レクリエーション: Erholung
枕 (まくら): Kopfkissen
その頃 (そのころ): in jener Zeit, damals, damalig
障子 (しょうじ): Shōji, Papierschiebetür, Schiebetür aus durchscheinendem Papier
護謨 (ゴム): Gummi
寄せる (よせる): (1) näher bringen, annähern, annähern lassen, (2) näher kommen, herankommen, sich nähern, (3) entgegenbringen (ein Gefühl), das Herz schenken, lieben, Zuneigung empfinden, (4) zusammenzählen, addieren, (5) sammeln, versammeln, zusammenbringen, (6) schreiben, zusammenschreiben, (7) schenken, beitragen, (8) besuchen lassen, (9) beiseite rücken, beiseite legen, (10) senden, schicken, (11) überlassen, anvertrauen, (12) eine Verbindung herstellen, etw. zum Vorwand nehmen, (13) anstürmen (Wellen, eine Herde, eine Armee), anbrausen, angreifen
シーツ: Laken, Bettuch
鉄橋 (てっきょう): Eisenbrücke, Eisenbahnbrücke
物指 (ものさし): (1) Lineal, Metermaß, Maßstab, Bandmaß, (2) Maßstab, Kriterium
間隔 (かんかく): (1) Zwischenraum, Abstand, Weite, Distanz, (2) Zeitabstand, Intervall, Weile, Pause, (3) Spatienbreite, Zwischenraum zwischen Buchstaben
有無 (うむ): (1) Vorhandensein, Existenz, Sein oder Nicht-Sein, (2) ja oder nein
粗衣 (そい): einfache Kleidung
散らかす (ちらかす): verstreuen, zerstreuen, in Unordnung bringen
生き生き (いきいき): lebendig, lebhaft, munter, animiert, belebt, frisch, rege, lebendig sein, lebhaft sein, munter sein, voller Lebensfrische
気を付ける (きをつける): (1) Acht geben, aufpassen, auf der Hut sein, ein Auge auf etwas haben, (2) aufmuntern, Energie geben
学術 (がくじゅつ): (1) Wissenschaft, Gelehrsamkeit, (2) Wissenschaft und Kunst, (3) Wissenschaft und Technik
スカーフ: Schal, Halstuch, Kopftuch, Schultertuch
文房具 (ぶんぼうぐ): Schreibwaren, Papierwaren, Schreibmaterial, Schreibbedarf, Büromaterial, Bürobedarf
夜行 (やこう): (1) nächtliches Herumstreunen, (2) Nachtzug (Abk.)
貸し出し (かしだし): (1) Darlehen, (2) Verleihen
煮る (にる): kochen, zubereiten, sieden, schmoren
言い出す (いいだす): (1) zu sprechen anfangen, (2) vorschlagen, einen Vorschlag machen, beantragen
純粋 (じゅんすい): (1) Reinheit, Echtheit, (2) Unschuld, Unverdorbenheit, Lauterkeit, Reinheit, rein, echt, pur, unverfälscht, unvermischt
跳ねる (はねる): (1) springen, hüpfen, hopsen, (2) aufspringen, auffahren, (3) sich aufbäumen, bocken, (4) spritzen (Wasser, Fett etc.)
いつの間にか (いつのまにか): (1) unbemerkt, bevor man es bemerkt hat, während man nicht aufgepasst hat, (2) irgendwann, früher oder später, eines Tages, so ungefähr
縮小 (しゅくしょう): Einschränkung, Verkleinerung, Verkürzung, Verminderung, einschränken, verkleinern, vermindern, abrüsten
冷める (さめる): (1) kalt werden, kühl werden, abkühlen, (2) abkühlen, sich legen, abflauen, nachlassen
現 (げん): (1) gegenwärtige Existenz, (2) gegenwärtige Anwesenheit, (3) gegenwärtig, aktuell, (4) gegenwärtige Welt, (5) die wirkliche Sache
センチ: (1) Hundertstel (Zeichen: c), (2) Zentimeter (Abk.), sentimental (Abk.)
花火 (はなび): Feuerwerk
割 (わり): (1) Verhältnis, Proportion, (mn) Bruchteil, Rate, (2) Prozent, Prozentsatz, v.H., (3) zehn Prozent, 10 %, (4) Verhältnis zwischen erwartetem Zustand und tatsächlichem Zustand, erwarteter Gewinn, (5) Wettkampf, (6) Anzeige der Wettkämpfe, (7) Teilen, (8) Anteil, Verteilung, Zuteilung, (9) Vernunft, Grund, Ursache, (10) Gerstenschrot (Abk. für wari・mugi割麦)
削る (けずる): kämmen, (1) feilen, anspitzen, abschaben, hobeln, abhobeln, (2) ausstreichen, wegstreichen, einschränken, kürzen
有料 (ゆうりょう): Gebührenpflicht, Kostenpflicht, gebührenpflichtig, zollpflichtig
一昨昨日 (いっさくさくじつ): (1) vorvorgestriger Tag, (2) vorvorgestern, vor drei Tagen, vorvorgestern (förmliche Aussprache)
チップ: (1) Chip, Spielgeld, (2) Chips, Pommes frites, (3) Chips, Kartoffelchips, (4) Chip, integrierter Schaltkreis, (5) Steinsplitter, (1) Trinkgeld, (2) Tip (mit der Seite des Schlägers geschlagener Ball), (3) Spitze (eines Filzstiftes)
偶数 (ぐうすう): gerade Zahl, gerade (Zahl)
意義 (いぎ): Bedeutung, Sinn, Bedeutsamkeit
嗅ぐ (かぐ): (1) etw. riechen, beschnüffeln, beschnuppern, (2) herausbekommen, erschnüffeln
狡い (ずるい): (1) verschmitzt, durchtrieben, gemein, verschlagen, gerissen, schlau, (2) geizig, knauserig, (1) schlau, listig, verschlagen, verschmitzt, durchtrieben, (2) gemein, unehrlich, unredlich, verlogen, falsch
振り仮名 (ふりがな): Furigana (Lesehilfe für Kanji in Kana)
張り切る (はりきる): (1) straff spannen, (2) angespannt sein, nervös sein, aufgeregt sein, (3) auf Draht sein, in bester Stimmung sein, in guter Form sein, enthusiastisch sein.
持参 (じさん): Mitbringen, Mitnehmen, Mitführen, Holen, Bringen, mitbringen, mitnehmen, mitführen, holen, bringen
まあまあ: (1) mäßig, befriedigend, so lala, (2) doch, bitte, (3) du meine Güte
機関車 (きかんしゃ): Lokomotive
巫山戯る (ふざける): (1) spielen, toben, (2) spaßen, Spaß machen, scherzen, (3) flirten, schäkern, (4) veräppeln, verschaukeln, sich lustig machen, verarschen
一通り (ひととおり): (1) Gesamtheit, (2) insgesamt, von Anfang bis Ende, im Großen und Ganzen, (3) Normalität, Gewöhnlichkeit, (4) eine Methode, (5) ein Durchgang, (1) ungefähr, im Großen und Ganzen, (2) besonders groß
カセット: Kassette
満点 (まんてん): (1) volle Punktzahl, größtmögliche Zahl erreichbarer Punkte, (2) Perfektion, perfekt, vollkommen zufriedenstellend
真空 (しんくう): Vakuum, luftleerer Raum, Vakuum…, luftleer
応用 (おうよう): Anwendung, praktische Anwendung, Nutzanwendung, anwenden
真っ暗 (まっくら): (1) totale Finsternis, (2) kein Hoffnungsschimmer, stockfinster, stockdunkel, ganz dunkel
曖昧 (あいまい): Unbestimmtheit, Undeutlichkeit, Unklarheit, Zweideutigkeit, Doppelsinn, unbestimmt, vage, mehrdeutig, undeutlich, unsicher, unklar, dunkel, doppelsinnig, unzuverlässig, unbestimmt, undeutlich, unsicher, unklar, dunkel, doppelsinnig, doppeldeutig, unzuverlässig
剃刀 (かみそり): Rasiermesser, Rasierklinge, Rasierapparat
国王 (こくおう): König, Landesherr, Monarch
仲良し (なかよし): guter Freund
前後 (ぜんご): (1) etwa, ungefähr, vorn und hinten, (2) vor und nach, vorher und nachher, (3) etwa, gegen, (4) Anordnung, Reihenfolge, (5) Konsequenz, außer Ordnung kommen, alles in einen Topf werfen
焦げる (こげる): (1) anbrennen, versengt werden, versengen, verbrennen, verkohlen, (2) braun werden (in der Sonne)
厳重 (げんじゅう): (1) Strenge, Genauigkeit, Härte, Schärfe, Unerbittlichkeit, (2) Feierlichkeit, Ernst, Würde, streng, scharf, genau, hart, streng, ernst, energisch, rigoros
伝染 (でんせん): Infektion, Ansteckung, sich infizieren, sich anstecken
西暦 (せいれき): (1) gregorianischer Kalender, christliche Zeitrechnung, (2) A.D, Anno Domini, nach Christus
峠 (とうげ): (1) Pass, Bergpass, (2) Krise, kritischer Punkt, kritisches Stadium, (3) Höhepunkt, Gipfel
体系 (たいけい): System
引っ越し (ひっこし): Umzug, Umziehen, umziehen
思いつく (おもいつく): einfallen, in den Sinn kommen, auf den Gedanken kommen, die Idee haben, sich einfallen lassen, anwandeln, verfallen auf …
農薬 (のうやく): Agrochemikalie, Agrarpestizid, in der Landwirtschaft verwendete Chemikalien
催し (もよおし): Veranstaltung, Treffen, Party
正 (せい): (1) Gerechtigkeit, (2) Normalität, Vollständigkeit, (3) Original, (4) Plus
太鼓 (たいこ): Trommel, Taiko
じゃん拳 (じゃんけん): Stein-Schere-Papier-Spiel, das Stein-Schere-Papier-Spiel spielen
薬品 (やくひん): (1) Medizin, Medikament, Arzneimittel, (2) Chemikalie
出鱈目 (でたらめ): Unsinn, Blödsinn, Quatsch
下車 (げしゃ): (1) Absteigen, Aussteigen (aus einem Fahrzeug), (2) Durchschreiten der Sperre am Ausstiegsbahnhof, absteigen, aussteigen
観測 (かんそく): (1) Beobachtung (der Sterne, des Wetters), Observation, (2) Vorhersage, Erwartung, Antizipation, (1) beobachten, observieren, (2) vorhersagen, antizipieren, erwarten
役者 (やくしゃ): (1) Schauspieler, (2) fähige Person
原稿 (げんこう): Manuskript, Entwurf, Beitrag
万歳 (ばんざい): (1) zehntausende Jahre, (2) Ewigkeit, ewiges Leben, (3) Banzai!, (4) Hurra!, (5) Er lebe hoch!, (6) Herzlichen Glückwunsch!, (7) Tod einer hochgestellten Persönlichkeit (als Ersatz für ein Tabuwort), (8) Heben beider Arme (weil man ohnehin nichts mehr tun kann)
始終 (しじゅう): von Anfang bis Ende, immer, ständig, ununterbrochen, die ganze Zeit
姪 (めい): Nichte
乾電池 (かんでんち): Trockenbatterie
人事 (じんじ): (1) menschliche Angelegenheit, (2) Personalangelegenheit, (3) das Menschenmögliche
派手 (はで): (1) Auffälligkeit, Buntheit, Grelle, (2) Pracht, Prunk, Luxus, prächtig, prunkhaft, auffallend, auffällig, grell, schreiend, knallig, luxuriös
重量 (じゅうりょう): Gewicht, Last
第一 (だいいち): zuerst, als Erstes, (1) (2) 
トレーニング: Training, trainieren
青白い (あおじろい): bleich, blass, fahl, aschgrau, kränklich
纏める (まとめる): (1) zusammenstellen, zusammenpacken, sammeln, (2) in Einklang bringen, (3) ordnen, (4) abschließen, zum Erfolg bringen
的確 (てきかく): Genauigkeit, Exaktheit, Bestimmtheit, Präzision, genau, exakt, bestimmt, präzis, in genauer Weise, genau, exakt, bestimmt
外れる (はずれる): (1) sich lösen, abgehen, sich abtrennen, entgleisen, (2) verrenkt sein, ausgerenkt sein, (3) verfehlen, daneben gehen, nicht treffen, (4) abweichen, verstoßen, übertreten, widersetzen
面倒くさい (めんどくさい): unbequem, lästig, störend, umständlich
催促 (さいそく): Mahnung, Aufforderung, Drängen, mahnen, drängen, erinnern
湯のみ (ゆのみ): Teeschale, Becher
車輪 (しゃりん): Wagenrad, Reifen
寸法 (すんぽう): (1) Maß, Größe, Abmessung, Ausmaß, Dimension, (2) Plan
散る (ちる): (1) abfallen (z.B. Blüten), sich verteilen, auf den Boden fallen, (2) außer sich sein, abgelenkt sein, zerstreut sein, (3) sich verbreiten, sich auflösen
形容詞 (けいようし): Adjektiv, Eigenschaftswort
見かけ (みかけ): äußere Erscheinung, Äußeres, Aussehen, Schein
這う (はう): kriechen, auf allen Vieren gehen
入社 (にゅうしゃ): Firmeneintritt, in eine Firma eintreten
診断 (しんだん): (1) Diagnose, Untersuchung, (2) Untersuchung, untersuchen
チョーク: Kreide, Choke (Luftklappe im Vergaser)
無限 (むげん): Mugen (Tōkyō), Unendlichkeit, Unbegrenztheit, Infinität, Unermesslichkeit, Ewigkeit, unendlich, unbegrenzt, infinit, unermesslich, ewig, unbegrenzt, unendlich, infinit
躓く (つまずく): (1) stolpern, straucheln, den Halt verlieren, (2) scheitern, einen Fehlschlag erleiden, (1) stolpern, den Halt verlieren, (2) einen Fehlschlag erleiden, scheitern
体操 (たいそう): (1) Turnen, Leibesübung, Gymnastik, Sport, (2) Turnwettbewerb, (3) Turnen, Schulsport, Sport (als Unterrichtsfach), turnen, Leibesübungen machen, Sport treiben
童話 (どうわ): Märchen
ネックレス: Halskette, Kette, Kollier
祭日 (さいじつ): (1) Festtag, Feiertag, (2) nationaler Feiertag
集会 (しゅうかい): Versammlung, Treffen, Meeting, treffen, sich versammeln
明くる (あくる): nächster, folgender
高級 (こうきゅう): hoher Rang, hoher Wert, Hochklassigkeit, Grad der Hochklassigkeit, erstklassig, hochgradig, hochwertig, Luxus…
お世話になる (おせわになる): jmdm. zur Last fallen, jmdm. Umstände bereiten
繋がり (つながり): Beziehung, Verhältnis, Zusammenhang, Verbindung, Gemeinschaft, Verwandtschaft
タイア: Reifen
液体 (えきたい): Flüssigkeit, flüssiger Aggregatzustand
割り算 (わりざん): Division, Teilen
広場 (ひろば): Platz, offene Fläche, Forum, Esplanade
刺さる (ささる): stechen, durchstechen, durchbohren
欄 (らん): Spalte, Kolumne, Zeitungskolumne
連合 (れんごう): (1) Vereinigung, Verbindung, Zusammenschluss, Koalition, Assoziation, Union, Bund, Allianz, (2) Rengō, japanischer Gewerkschaftsbund,  (sich) vereinen, vereinigen, vereinigt, verbündet, vereint
卑怯 (ひきょう): (1) Ängstlichkeit, Feigheit, (2) Niedertracht, feige, gemein, unfair
判事 (はんじ): Richter
刺す (さす): (1) stechen, einstechen, durchstechen, (2) stechen, beißen, (3) sticken, nähen
刺身 (さしみ): Sashimi (in Scheiben geschnittener roher Fisch)
写る (うつる): aufgenommen werden, gefilmt werden, fotografiert werden, fotografiert werden, aufgenommen werden
裂く (さく): (1) zerreißen, (2) aufschneiden, zerteilen, (3) entzweien, trennen, entfremden, (4) erübrigen, übrig haben, haben, (5) tätowieren
行列 (ぎょうれつ): (1) Zug, Prozession, Aufzug, Menschenschlange, (2) Matrix, sich anstellen, Schlange stehen
民間 (みんかん): (1) Zivilgesellschaft, (2) Privat…, Zivil…, Nichtregierungs…, unter dem Volk, privat, zivil
風呂敷 (ふろしき): Furoshiki, Einwickeltuch (zum Transport)
涼む (すずむ): sich an der kühlen Luft erfrischen, die Kühle genießen, sich abkühlen
直前 (ちょくぜん): (1) unmittelbar vor, gerade vor, kurz vor, (2) direkt vor den Augen
古 (ふる): etw. Altes
お世話 (おせわ): Bemühung, Hilfe, Sorge, Beistand, Unterstützung
正方形 (せいほうけい): Quadrat, quadratisch
散らかる (ちらかる): sich zerstreuen, in Unordnung geraten
祖先 (そせん): Vorfahr, Ahne
払い込む (はらいこむ): bezahlen, zahlen, einzahlen
その為 (そのため): (1) aus diesem Grund, daher, deswegen, (2) zu diesem Zweck, (3) in der Konsequenz
しゃぶる: lutschen, saugen
響き (ひびき): (1) Klang, Klangfärbung, (2) Echo, Resonanz, Anklang, (3) Erschütterung, Vibration, (4) Einfluss, Effekt
一旦 (いったん): (1) einmal, (2) vorläufig, zunächst, (3) kurzzeitig, (4) ein Morgen, ein Tag
整う (ととのう): (1) geordnet sein, in Ordnung sein, reguliert sein, gestimmt sein, (2) vorbereitet sein, bereit sein, in Bereitschaft sein, (3) abgeschlossen sein, zu Ende sein
綱 (つな): Seil, Tau, Trosse, Strick, Leine
酢 (す): Essig
自習 (じしゅう): autodidaktisches Lernen, Selbstunterricht, Selbststudium, selbständiges Lernen, für sich selbst lernen
月末 (げつまつ): Monatsende, Ende des Monats, Ende des Monats, Monatsende, zum Monatsende
果実 (かじつ): (1) Frucht, Obst, (2) Nutzen
倉庫 (そうこ): Speicher, Magazin, Lagerhaus, Lagerschuppen
領事 (りょうじ): Konsul, konsularisch
分かれる (わかれる): geteilt sein, auseinander gehen, abzweigen, sich spalten
修繕 (しゅうぜん): Reparatur, Ausbesserung, Instandhaltung, Wiederherstellung, reparieren, ausbessern, wiederherrichten
彫る (ほる): (1) hauen, meißeln, schnitzen, schneiden, gravieren, stechen, (2) tätowieren
潜る (もぐる): (1) tauchen, untertauchen, (2) sich verkriechen, (3) sich absetzen, untertauchen
ずらり: in einer Reihe, in einer Reihe, in Mengen
鈍い (にぶい): (1) langsam, träge, schleppend, (2) beschränkt, begriffsstutzig, (3) nachsichtig, vernarrt, (1) stumpf, glanzlos, matt, (2) träge, schwerfällig, dumpf, empfindungslos, dickfellig, dickhäutig, (3) schwach, trüb, blass
架空 (かくう): (1) Frei…, Ober…, Luft…, Hänge…, Schwebe…, (2) Grundlosigkeit, Irrealität, (3) Fiktion, Hypothese, imaginär, ausgedacht, fiktiv, aus der Luft gegriffen
校舎 (こうしゃ): Schulgebäude, Schulhaus
予備 (よび): (1) Reserve, Vorrat, Ersatz, (2) Vorbereitung, (1) Ersatz…, Reserve…, (2) Vor…, Vorbereitungs…
水蒸気 (すいじょうき): Wasserdampf
巡査 (じゅんさ): Schutzmann, Polizist
上品 (じょうひん): Feinheit, Eleganz, Anmut, Kultiviertheit, Raffiniertheit, Vornehmheit, fein, vornehm, gepflegt, elegant, anmutig, kultiviert, raffiniert, elegant, anmutig, kultiviert, raffiniert, vornehm
殖やす (ふやす): vermehren, vergrößern, verstärken, erhöhen, anwachsen lassen
光線 (こうせん): (1) Licht, (2) Lichtstrahl
螺子 (ねじ): Schraube
努める (つとめる): sich bemühen, sich anstrengen, fleißig arbeiten
人造 (じんぞう): künstliche Herstellung, künstlich, Kunst-, synthetisch
商店 (しょうてん): Geschäft, Laden, Kaufladen
道順 (みちじゅん): Wegfolge, Route
地盤 (じばん): (1) Boden, Untergrund, (2) Fundament, Unterbau, (3) Einflussgebiet, Wählerschaft, (4) Position, Stellung, (5) Stützpunkt, Operationsbasis
襤褸 (ぼろ): (1) Lumpen, Fetzen, (2) Schwäche, Makel, Lumpen, Fetzen
短所 (たんしょ): Schwäche, schwache Seite, Fehler, Mangel, Nachteil
感想 (かんそう): Gedanke, Eindruck, Empfindung, Gefühl, Meinung, Ansicht
掘る (ほる): (1) graben, bohren, aushöhlen, ausschachten, (2) ausgraben, (3) mit der Wurzel ausgraben (eine Pflanze)
セメント: Zement
点々 (てんてん): (1) vereinzelt, verstreut, gesprenkelt, hier und dort, (2) tropfend fallen, vereinzelt, verstreut, hier und dort
着替える (きがえる): Kleider wechseln, sich umziehen
その他 (そのほか): außerdem, überdies, darüber hinaus, weiter, (1) andere, die anderen, (2) darüber hinaus, außerdem, darüber hinaus
煉瓦 (れんが): Ziegel, Ziegelstein, Backstein
競馬 (けいば): (1) Pferderennen, (2) Pferderennsport
公務 (こうむ): Amt, Staatsdienst, Amtsdienst, Dienst, Dienstsache
下線 (かせん): (1) Unterstreichung, (2) Unterstrich, _ (engl. underscore; ANSI-Code 0095)
停車 (ていしゃ): Halt, Aufenthalt, Halten, Anhalten, halten, anhalten
ナイロン: Nylon
東西 (とうざい): (1) Ost und West, (2) der Osten und der Westen
随筆 (ずいひつ): (mn) Essay, Miszellenliteratur, literarische Notiz, Zuihitsu (Literaturgenre, das Erfahrungen, Erlebnisse und Eindrücke ins Zentrum stellt und weniger die äußere Form)
火山 (かざん): Vulkan, feuerspeiender Berg, Feuerberg, vulkanisch
割合に (わりあいに): verhältnismäßig
見送る (みおくる): (1) nachsehen, mit den Augen verfolgen, (2) begleiten, geleiten, (3) bis zum Tode pflegen, (4) hinausschieben (die Verwirklichung eines Planes), verschieben, offen lassen (eine Frage), (5) übersehen
一まず (ひとまず): für eine Weile, vorläufig, erst einmal, zunächst
遠足 (えんそく): (1) Ausflug, Tagesausflug, Exkursion, langer Spaziergang, (2) Schulexkursion, einen Ausflug machen, eine Exkursion machen
屋外 (おくがい): das Freie, freie Luft, Außen…, Freiluft…, Freilicht…
木材 (もくざい): Bauholz, Holz
当番 (とうばん): (1) Dienst, Schicht, (2) Diensthabender
憎む (にくむ): hassen, grollen, feindlich gesinnt sein, verabscheuen
団 (だん): Team, Gruppe, Kreis, Dan
室 (しつ): (1) Zimmer, Raum, (2) …raum, …zimmer, (3) Abteilung, (4) Mätresse, Gattin
功績 (こうせき): großer Erfolg, verdienstvolle Tat, Verdienst, anerkennenswerte Leistung
プラットホーム: (1) Bahnsteig, Bussteig, (2) Betriebssystem-Plattform
バランス: Gleichgewicht, Balance
問い合わせ (といあわせ): (1) Anfrage, Erkundigung, (2) Abfrage, Query (einer Datenbank)
早速 (さっそく): sofort, jetzt gleich, im Augenblick, auf der Stelle, unverzüglich
効力 (こうりょく): Wirksamkeit, Wirkung, Gültigkeit, Effektivität, Effekt, Erfolg
活字 (かつじ): Druckbuchstabe, Letter, Drucktype, Type, Schrift
捕らえる (とらえる): (1) fangen, fassen, erfassen, (2) festnehmen, verhaften, ergreifen, (3) bekommen, ergreifen (eine Chance), (4) begreifen
鉱物 (こうぶつ): Mineral
渇く (かわく): (1) durstig sein, (2) den Reiz verlieren, kalt werden
娯楽 (ごらく): (1) Unterhaltung, Zerstreuung, Belustigung, (2) Vergnügung, Zeitvertreib, Amüsement
吃逆 (しゃっくり): Schluckauf, Schluckauf haben
憎い (にくい): (1) widerwärtig, boshaft, verhasst, abscheulich, verabscheuungswürdig, gehässig, unausstehlich, (2) beneidenswert sein
家主 (やぬし): Hausherr, (1) Hausbesitzer, (2) Vermieter
名物 (めいぶつ): (1) berühmtes Produkt, charakteristisches Produkt, Spezialität (einer Gegend), (2) Berühmtheit, Zelebrität
低下 (ていか): (1) Sinken, Herabsinken, Fallen, Verminderung, Entwertung, Wertverminderung, (2) Verschlechterung, sinken, herabsinken, fallen, sich vermindern, sich entwerten, sich verschlechtern
応ずる (おうずる): (1) antworten, erwidern, annehmen, (2) entsprechen
解説 (かいせつ): Erklärung, Erläuterung, Kommentar, Interpretation, Einführung, erläutern, erklären, kommentieren, interpretieren, auslegen
オートメーション: Automation
観念 (かんねん): (1) Anschauung, Vorstellung, Konzept, (2) Idee, (3) Gefasstheit, Fassung, Resignation, (4) Nachdenken über die Wahrheit (eine Meditationsmethode), sich bereit finden, sich gefasst machen, zu einem Entschluss kommen, resignieren, sich überwunden haben
モデル: (1) Modell, Version eines Autos oder einer Maschine, (2) Modell, (3) Mannequin, Modell
寝巻き (ねまき): Nachthemd, Schlafanzug, Pyjama
名所 (めいしょ): (1) berühmter Ort, (2) Vor‑ und Zuname und Adresse, (3) Namen der Teile eines Gerätes, berühmter Ort, Sehenswürdigkeit
別々 (べつべつ): einzeln, getrennt, verschieden, einzelne, getrennte, verschiedene
しつこい: (1) lästig, aufdringlich, hartnäckig, beharrlich, zäh, (2) penetrant, unangenehm (Geschmack; Geruch), (3) schwer, schwer bekömmlich, fett (Essen), (4) zu bunt, grell, knallig, (1) lästig, aufdringlich, hartnäckig, beharrlich, zäh, (2) schwer, fett, (3) zu bunt, grell
編 (へん): Herausgeber, herausgegeben von …, Band, Buch
食塩 (しょくえん): Kochsalz, Speisesalz, Tafelsalz
ニコニコ: lächelnd, mit einem Lächeln, lächeln, strahlen, schmunzeln, niconico (japan. Portalseite)
膨らむ (ふくらむ): anschwellen, sich ausdehnen
着々 (ちゃくちゃく): Schritt für Schritt, langsam aber sicher, stetig, sicher, Schritt für Schritt
悔やむ (くやむ): (1) bereuen, Reue empfinden, bedauern, beklagen, (2) betrauern, bedauern
窓口 (まどぐち): (1) Schalter, Fahrkartenschalter, (2) Schalterbeamter, Kontaktperson, Ansprechpartner
雑巾 (ぞうきん): Wischtuch, Putzlappen
白髪 (しらが): weißes Haar, graues Haar, weißhaarig, grauhaarig
戸棚 (とだな): Schrank
洗面 (せんめん): Gesichtwäsche, sein Gesicht waschen
蘇る (よみがえる): (1) wieder ins Leben zurückkommen, wieder zu sich kommen, wieder aufleben, wieder aufblühen, (2) sich wieder beleben, sich neu beleben, (3) zurückkommen, wieder erstarken
火口 (かこう): Vulkankrater, Krater, Vulkantrichter
会館 (かいかん): (1) Klubhaus, Vereinsgebäude, (2) …‑Haus, …‑Gebäude, …‑Halle, (3) (in China)Ständehaus, Landsmannschaftenhaus
恐縮 (きょうしゅく): (1) Zusammenschrumpfen des Körpers aufgrund von Furcht, (2) Zusammenschrumpfen des Körpers aufgrund von großer Beschämung oder Verlegenheit, (3) mein tiefster Dank!, meine aufrichtige Entschuldigung!, meine demütigste Bitte!, (1) jmdm. verbunden sein, sich zum Dank verpflichtet fühlen, (2) sich schämen, sich genieren, bedauern
それなのに: aber, trotzdem, jedoch, allein
打付ける (うちつける): (1) schlagen, stoßen, (2) einschlagen
体積 (たいせき): Volumen, Rauminhalt
日用品 (にちようひん): Waren für den täglichen Bedarf
図形 (ずけい): (1) Figur, (2) Grafik, Diagramm
大層 (たいそう): (1) sehr, äußerst, außerordentlich, ungemein, (2) viel, überreichlich, in großer Menge, (3) übertrieben
うろうろ: (1) unruhig, unruhig gehend, nervös, (2) unklar, undeutlich, umherstreichend, herumlungernd, (1) umherschlendern, herumstreichen, herumlungern, (2) durcheinandergeraten, aus der Fassung kommen
状 (じょう): Zustand, Lage, Umstände, Form, Brief
フリー: (1) Kostenlosigkeit, (2) Freiheit, (3) freier Mitarbeiter, (4) Kleidungsstück (o.ä.) in Universalgröße, (1) frei, unabhängig, (2) umsonst, kostenlos, freiberuflich, frei
育児 (いくじ): (1) Kinderpflege, Säuglingspflege, (2) Großziehen eines Kindes, Kinder aufziehen, Kinder pflegen
業 (ぎょう): (1) Arbeit, Dienst, Beruf, Gewerbe, (2) Studium, Lernen, Training
先頭 (せんとう): Spitze, Front, Erster, Anfang, Kopf (einer Seite)
馬鹿らしい (ばからしい): dumm, blöd, blödsinnig, einfältig, albern, töricht, unsinnig, lächerlich
ショップ: Laden
出迎える (でむかえる): empfangen, abholen, entgegengehen
生える (はえる): wachsen, sprießen, ausschlagen, durchbrechen, überwuchern
警備 (けいび): Wache, Bewachung, bewachen, beschützen
水分 (すいぶん): Wassergehalt
採る (とる): (1) annehmen, nehmen, anstellen, (2) sammeln (Pflanzen, Insekten), (3) einnehmen (eine Haltung)
乗車 (じょうしゃ): Einsteigen, Besteigen, einsteigen, besteigen
銅 (どう): Kupfer
足跡 (あしあと): Fußspur, Fußstapfen, (1) Fußspur, Fußstapfen, (2) Beitrag, Leistung
今 (こん): Kon
接する (せっする): (1) berühren, in Berührung kommen, (2) grenzen an, anstoßen an, (3) bekommen, erfahren, (4) empfangen, behandeln, bedienen, (5) erleben
長所 (ちょうしょ): Stärke, starke Seite, bessere Eigenschaft, Vorteil, Vorzug, Verdienst
お休み (おやすみ): (1) Ruhetag, Urlaub, Ferien, (2) Schlafen, (3) Gute Nacht!, (4) Nacht! (informell)
カーブ: (1) gebogene Linie, (2) Kurve, Biegung, Krümmung, (3) Curve-Ball, eine Kurve machen
直線 (ちょくせん): (1) gerade Linie, Gerade, (2) Gerade
死体 (したい): Leiche, Leichnam, lebloser Körper, leblos
欧米 (おうべい): Europa und Amerika, der Westen, europäisch und amerikanisch, westlich, okzidental
動作 (どうさ): Bewegung, Betrieb, Auftreten, Aufführung, Benehmen, Betragen, Gebärde, Handlung, Verhalten, laufen, funktionieren
襖 (ふすま): Fusuma, Schiebetür, Schiebewand (zwischen Zimmern mit festem, undurchsichtigem Papier in einem Holzrahmen)
公共 (こうきょう): (1) Allgemeinheit, Öffentlichkeit, Gemeinnutz, Publikum, (2) öffentlicher Besitz, öffentlich, gemeinnützig, Gemein-, staatlich
若しかすると (もしかすると): wenn es Ihnen recht ist, eventuell, vielleicht
御覧 (ごらん): (1) (höflich für) das Sehen eines anderen, (2) Sehen Sie bitte
特定 (とくてい): Identifizierung, Bestimmung, spezifizieren, bestimmen, bestimmt, spezifisch
注す (さす): (1) gießen, (2) einfärben
寮 (りょう): (1) Wohnheim, Studentenwohnheim, Studentenheim, Internat, (2) Angestelltenwohnheim, (3) Nebenresidenz, Villa, (4) Haus für die Teezeremonie
コーラス: Chor, Chorus
粒 (つぶ): (1) Korn, Körnchen, Tropfen, (2) Zählwort für Körner und Tropfen
湯気 (ゆげ): Dampf, Wasserdampf
重なる (かさなる): (1) übereinanderliegen, sich ansammeln, sich häufen, aufeinanderfolgen, sich stapeln, (2) zusammenfallen (z.B. Feiertage)
隔てる (へだてる): (1) fernhalten, abschirmen, abtrennen, auseinanderhalten, abteilen, (2) zwischen etw. liegen, (3) trennen, unterscheiden, (4) entfremden, abtrünnig machen, abbringen, trennen
災難 (さいなん): Unglück, Missgeschick, Unfall, Katastrophe
下品 (げひん): (1) Grobheit, Vulgarität, Gemeinheit, Primitivität, Niedrigkeit, (2) Minderwertigkeit, schlechte Qualität, (1) Grad der Vulgarität, (2) Vulgarität, gemein, niedrig, vulgär
日の入り (ひのいり): Sonnenuntergang
商業 (しょうぎょう): Handel, Handelsbetrieb, Geschäft, Handels…
攻める (せめる): angreifen, zum Angriff übergehen, attackieren, losschlagen
初級 (しょきゅう): Grundstufe, Unterstufe, Anfängerklasse, Anfänger…, Grund…
弁 (べん): (1) Blütenblatt, (2) Ventil, Ventilklappe, (3) Herzklappe, Venenklappe, (4) Rohrblatt, (1) Sprechen, Sprechweise, Sprache, Reden, (2) Dialekt, Mundart, Akzent, Benkan (Beamtenrang im Ritsuryō-System)
心当たり (こころあたり): Wissen, Ahnung, Vorstellung, Mutmaßung
盛る (もる): (1) auffüllen, füllen, (2) aufhäufen, anhäufen, (3) verabreichen, geben, (4) markieren, mit einer Skala versehen, (5) zurechtmachen, herrichten, schminken, (6) aufbauschen, übertreiben
文体 (ぶんたい): Stil, Schreibstil, Ausdrucksweise
時速 (じそく): Geschwindigkeit (pro Stunde), Stundengeschwindigkeit
攻め手 (せめて): (1) Angreifer, (2) Angriffsmacht, Angriffsmittel, Angriffszug, (3) Angriffsmethode
ヘリコプター: Hubschrauber, Helikopter
速達 (そくたつ): Eilpost, Eilsendung, Eilbrief, Eilzustellung
片付く (かたづく): (1) in Ordnung kommen, wohl geordnet werden, (2) erledigt werden, sich erledigen, fertig werden, (3) endigen, zum Abschluss kommen, (4) sich verheiraten (die Tochter)
青少年 (せいしょうねん): Jugend, (mf) Jugendliche, junge Leute, junges Volk
手前 (てまえ): (1) (2) , mir, mein
用語 (ようご): (1) Fachausdruck, Fachwort, Terminus technicus, Terminologie, (2) Wortschatz, Sprache, Vokabular
溜める (ためる): (1) anhäufen, sammeln, (2) sparen, horten, zurücklegen, (3) im Rückstand sein
物置 (ものおき): Rumpelkammer, Abstellkammer, Schuppen, Lager, Scheune
鐘 (かね): Glocke
経度 (けいど): Längengrad, geographische Länge
公衆 (こうしゅう): (1) Öffentlichkeit, Allgemeinheit, Publikum, (2) öffentliches …, öffentlich, allgemein
ファスナー: Reißverschluss
妨げる (さまたげる): stören, hindern, behindern, hemmen
驚かす (おどろかす): (1) überraschen, Bewunderung erregen, in Erstaunen setzen, verblüffen, (2) erschrecken, Schrecken einflössen, (3) aufmerksam machen, warnen, (4) aufwecken, (5) benachrichtigen, (6) besuchen
勇ましい (いさましい): tapfer, mutig, kühn, herzhaft, beherzt, mannhaft, männlich, aufmunternd, herzbewegend, zackig
隻 (せき): (1) Zählwort für Schiffe, (2) eines (von einem Paar)
水滴 (すいてき): Wassertropfen
勝敗 (しょうはい): Sieg oder Niederlage, Ausgang eines Kampfes
女の人 (おんなのひと): Frau
閉会 (へいかい): Schluss bzw. Schließung einer Versammlung, Schluss bzw. Schließung einer Sitzung, eine Versammlung schließen, eine Sitzung schließen
悔しい (くやしい): (1) bedauerlich, beklagenswert, ärgerlich, unglücklich, traurig, schmerzlich, tragisch, arg, (2) unerwartet, enttäuschend, (3) ungenügend, (1) frustrierend, verdrießlich, ärgerlich, (2) bereuenswert, bedauerlich, bedauernswert
早口 (はやくち): (1) hastiges Sprechen, (2) Zungenbrecher
循環 (じゅんかん): Kreislauf, Umlauf, Zirkulation, Rotation, zirkulieren, einen Kreislauf bilden, rotieren, umlaufen, kreisen, wiederkehren
草臥れる (くたびれる): (1) müde werden, ermüden, ermatten, erschöpft sein, (2) abgetragen sein, verbraucht sein
送料 (そうりょう): Porto, Transportkosten
さっさ: schnell, rasch, eilig, flink, fix, flott, hurtig, prompt, schleunig, zügig
対立 (たいりつ): Gegensatz, Gegenüberstellung, Konfrontation, feindliches Gegenüberstehen, Opposition, Antagonismus, sich gegenüberstehen, einen Gegensatz bilden, im Gegensatz stehen
強気 (つよき): (1) Überzeugtheit, Angriffslust, Aggressivität, (2) Haussieren, Hausse, angriffslustig, aggressiv, selbstsicher, unnachgiebig, dickköpfig
姿勢 (しせい): (1) Körperhaltung, Pose, Positur, (2) Haltung, Einstellung
園芸 (えんげい): Gärtnerei, Gartenbau, Gartenkunst, Hortikultur
図々しい (ずうずうしい): frech, unverschämt, verschlagen, zudringlich, aufdringlich
残らず (のこらず): alles, restlos, ganz, gänzlich, hundertprozentig, sämtlich, vollkommen
坊ちゃん (ぼっちゃん): (1) Sohn, junger Herr (höfliche Bez.), (2) Junge, Sohn, (3) Muttersöhnchen, großes Kind, grüner Junge
バンド: (1) Band, Gürtel, (2) Band, Kapelle, (3) Band, (4) Band, Frequenzband
血圧 (けつあつ): Blutdruck
過半数 (かはんすう): Mehrheit, Majorität
幼稚園 (ようちえん): Kindergarten
寺院 (じいん): (1) (buddh.)Tempel, (2) Kathedrale, Kirche
箪笥 (たんす): Kommode, Schrank, Kleiderschrank
上旬 (じょうじゅん): die ersten zehn Tage eines Monats, erstes Drittel eines Monats
筆記 (ひっき): Mitschreiben, Aufzeichnung, Notiz, mitschreiben, sich Aufzeichnungen machen, sich Notizen machen, nachschreiben, schriftlich
整数 (せいすう): ganze Zahl, Ganzzahl
区分 (くぶん): (1) Verteilung, Austeilung, Zuteilung, (2) Klassifikation, Einteilung, (3) Abteilung, Sektion, (4) Kategorie (eng. division), einteilen, klassifizieren
運河 (うんが): Kanal
糊 (のり): (1) Klebstoff, Kleber, Kleister, (2) Stärke
くっ付く (くっつく): (1) anhängen, anhaften, kleben an …, (2) berühren, (3) dicht stehen an …, (4) Arm in Arm gehen, (5) in ein intimes Verhältnis treten, eine wilde Ehe führen
思い切り (おもいきり): (1) Entsagung, Verzicht, Resignation, (2) Entschluss, Entscheidung, (3) nach Herzenslust, so viel, wie es einem gefällt
少なくとも (すくなくとも): wenigstens, mindestens, zumindest
傾く (かたむく): (1) sich neigen, schräg liegen, sich auf die Seite legen, Schlagseite bekommen, (2) zur Neige gehen, sich zum Untergang neigen, (3) untergehen, sinken (Sonne, Mond etc.), (1) sich neigen, schräg liegen, sich auf die Seite legen, Schlagseite bekommen, (2) einer Sache zuneigen, Zuneigung für etw. habe, eine Tendenz zu etw. haben, (3) zur Neige gehen, sich zum Untergang neigen, schwächer werden, (4) untergehen, sinken (Sonne, Mond etc.), (5) (bei Shimo・nidan-Konjugation) neigen, schräg stellen, kippen
改めて (あらためて): (1) aufs Neue, von neuem, noch einmal, (2) wieder, wieder einmal, ein anderes mal, später
線路 (せんろ): Gleis, Bahnlinie, Linie, Schiene, Schienenweg
消毒 (しょうどく): Desinfektion, Sterilisation, Sterilisierung, desinfizieren, sterilisieren
碁 (ご): Go-Spiel, Go (ostasiat. Brettspiel für zwei Personen; wird mit 181 schwarzen und 180 weißen Steinen auf einem quadrat. Brett gespielt; Spieler versuchen mit eigenen Steinen zusammenhängende Ketten zu bilden und dadurch Raum bzw. gegnerische Steine einzukreisen und so zu erobern)
含める (ふくめる): (1) einschließen, umfassen, (2) belehren, erklären, mitteilen, unterweisen, überreden, verständigen
蛍光灯 (けいこうとう): (1) Fluoreszenzlampe, Leuchtstoffröhre, Neonlampe, Neonröhre, (2) langsame, geistig träge Person, Spätzünder
平日 (へいじつ): gewöhnlicher Tag, Werktag, Wochentag, Alltag
目次 (もくじ): Inhaltsverzeichnis, Inhalt
こっそり: heimlich, verborgen, im Verborgenen, verstohlen, alles, restlos, bis aufs letzte
荒れる (あれる): (1) veröden, öde werden, verwildern, verfallen, herunterkommen, verlassen werden, (2) stürmisch werden, (3) rissig werden, rau werden
先ほど (さきほど): vorhin, vor kurzem, gerade
足袋 (たび): Tabi (japan. Socken mit abgeteilter großer Zehe)
出来上がり (できあがり): Vollendung, Fertigstellung
威張る (いばる): angeben, groß tun, stolz sein, hochmütig sein, prahlen
湿気 (しっけ): Feuchtigkeit, Nässe
灯油 (とうゆ): Lampenöl, Kerosin, Paraffin
創作 (そうさく): (1) Schöpfung, Schaffung, (2) Dichtung, Novelle, Roman, (3) Erfindung, ausgedachte Lüge, Fälschung, schaffen, dichten, schreiben, verfassen
材木 (ざいもく): Holz, Bauholz
生け花 (いけばな): (1) Ikebana, Blumenstecken, (2) japanisches Blumengesteck (folgt bestimmten ästhetischen und philosophischen Regeln), (1) Ikebana, (2) lebende Blume, frische Blume
特長 (とくちょう): Stärke, starke Seite
役所 (やくしょ): Amt, Behörde
省略 (しょうりゃく): Auslassung, Abkürzung, Ellipse, auslassen, abkürzen, weglassen
深夜 (しんや): Mitternacht, tiefe Nacht, späte Nacht, mitternachts, tief in der Nacht, in der späten Nacht, um Mitternacht
助教授 (じょきょうじゅ): Assistenzprofessor
出張 (しゅっちょう): Dienstreise, Geschäftsreise, Kundenbesuch, eine Dienstreise machen, in Amtsgeschäften reisen
好き嫌い (すききらい): Vorliebe und Abneigung
載る (のる): (1) liegen (auf …), (2) berichtet werden (geschrieben) stehen, erscheinen
歯車 (はぐるま): Zahnrad, Ritzel
一休み (ひとやすみ): kurze Pause, Verschnaufpause, kurz verschnaufen, eine kurze Pause machen
応接 (おうせつ): Empfang, Audienz, Interview, empfangen
出場 (しゅつじょう): Auftreten, Teilnahme, teilnehmen, sich beteiligen, mitspielen
詰まる (つまる): (1) gefüllt sein, voll sein, vollgestopft sein, (2) verstopft sein, sich verstopfen, (3) ins Stocken geraten, stocken, stecken bleiben, (4) schrumpfen, einschrumpfen, kürzer werden, kleiner werden, eingehen, (5) ratlos sein, nicht ein noch aus wissen, schachmatt sein, (6) den Ball mit dem Schläger nahe der Greifhand treffen, (7) mangeln, knapp sein
写生 (しゃせい): Skizzieren, Malen nach der Natur, Zeichnen nach der Natur, skizzieren, nach der Natur zeichnen, nach der Natur malen
限度 (げんど): Grenze, Begrenzung, Schranke, Limit
瓶詰め (びんづめ): Flaschenabfüllung, in Flaschen abgefüllt
安易 (あんい): (1) Einfachheit, Leichtigkeit, Mühelosigkeit, (2) Unbekümmertheit, Sorglosigkeit, Leichtsinnigkeit, (1) Grad der Einfachheit, (2) Einfachheit, Leichtigkeit, (3) Grad der Unbekümmertheit, Unbekümmertheit, Sorglosigkeit, bequem, zu leicht
ピンク: (1) Pink, Rosa, (2) Sinnlichkeit, Erotik, Lüsternheit, rosa, pink
大工 (だいく): (1) Zimmermann, (2) Zimmermannsarbeit
熟語 (じゅくご): (1) Kanji-Kompositum, Jukugo, (2) zusammengesetztes Wort, Redensart, geläufige Redewendung, Idiom
紫 (むらさき): (1) Purpurfarbe, Violett, Lila, (2) Sojasoße, (3) Steinsame, Steinhirse, Lithospermum officinale subsp. erythrorhizon
岬 (みさき): Kap, Landzunge
新幹線 (しんかんせん): Shinkansen, japanischer Hochgeschwindigkeitszug (wörtl. neue Stammstrecke; elektrisch betriebenes, normalspuriges Eisenbahnfernschnellnetz in Japan)
刻む (きざむ): (1) fein schneiden, klein schneiden, hacken, schnetzeln, (2) kerben, einkerben, gravieren, eingravieren, meißeln, einmeißeln, schnitzen, ritzen, (3) ticken (Uhr), verstreichen (Zeit), in kleinen Schritten voranschreiten, (4) sich etw. zu Herzen nehmen, fest im Gedächtnis verankern, sich etw. fest einprägen, (5) sich dem Flaggenstock nähern, (6) tätowieren, (7) quälen, peinigen, martern
焦点 (しょうてん): (1) Brennpunkt, Fokus, (2) Konzentration, Fokussierung
受験 (じゅけん): Ablegen einer Prüfung od. eines Examens, Ablegen einer Aufnahmeprüfung, Ablegen eines Eignungstests (z.B. für einen Firmeneintritt), sein Examen machen, eine Prüfung ablegen
呆れる (あきれる): (1) verblüfft sein, sprachlos sein, (2) eines Dinges überdrüssig werden, jmdm. verleidet werden
相撲 (すもう): Sumō, japanischer Ringkampf
好き好き (すきずき): Geschmacksache, eine Frage des Geschmackes
項目 (こうもく): (1) Gliederungspunkt, Punkt, Eintrag, Listeneintrag, Abschnitt, Absatz, (2) Eintrag, Stichwort, Lemma, (3) Kategorie, (4) Rechnungsposten, Posten
小数 (しょうすう): (1) kleine Zahl, (2) Dezimalbruch, Dezimalzahl
ひっくり返る (ひっくりかえる): (1) umstürzen, umschlagen, umfallen, sich umkehren, sich auf den Rücken legen, (2) umgestürzt werden, umgekehrt werden
灰色 (はいいろ): (1) Grau, Aschgrau, (2) Düsterheit, Dunkelheit, Trübsinn, (3) Trockenheit, Prosaik, (4) Unklarheit, (5) Verdacht, grau
湿る (しめる): feucht werden, nass werden
通勤 (つうきん): Pendeln ins Geschäft, Anfahrt zur Arbeit, Fahrt zum Dienst, zur Arbeit pendeln, ins Geschäft gehen, zur Arbeit gehen
序 (ついで): Gelegenheit
煎る (いる): rösten, dörren, brennen, braten
モーター: Motor
目眩 (めまい): Schwindel, Schwindelgefühl
みたい: (1) wie, ähnlich wie, (2) scheinen, aussehen wie, (3) wie, genauso wie, ebenso wie
売店 (ばいてん): Verkaufsstand, Kiosk, Bude
飢饉 (ききん): (1) Hungersnot, Nahrungsmittel-Knappheit, Hungerkatastrophe, (2) Mangel, Knappheit
乱暴 (らんぼう): Gewalttätigkeit, Rücksichtslosigkeit, Rohheit, Unfug, Grobheit, Wildheit, Gewalt antun, Unfug treiben, sich wie wild gebärden, gewaltsam, gewalttätig, rücksichtslos, grob, roh, wild, schonungslos, störrisch, in grober Weise, roh, gewalttätig, rücksichtslos, wild
エチケット: (1) Etikette, feiner Ton, (2) Etikett, Schild, (3) Weinetikett
司会 (しかい): (1) Vorsitz, Leitung, Moderation, (2) Moderator, den Vorsitz führen, leiten
出迎え (でむかえ): Abholen, Empfang, Begrüßung
拡充 (かくじゅう): Erweiterung, Vergrößerung, Ausdehnung, Expansion, Ausbau, Verstärkung, erweitern, ausdehnen, vergrößern, verstärken
清書 (せいしょ): Reinschrift, Reinschreiben, eine Reinschrift anfertigen, ins Reine schreiben
成分 (せいぶん): Bestandteil, Ingredienz, Komponente, Inhalt
目下 (めした): Jüngerer, Untergeordneter, Untergebener
停止 (ていし): (1) Stoppen, Stillstand, Stehenbleiben, Unterbrechung, (2) Einstellung, Stilllegung, zeitweilige Aufhebung, Bann, (3) Suspension, (4) Blockade, (5) Abschaltung, stehen bleiben, aufheben, einstellen
締め切る (しめきる): (1) schließen, abschließen, zuschließen, (2) beenden (eine Liste)
活躍 (かつやく): (1) energische Tätigkeit, große Aktivität, große Wirksamkeit, Geschäftigkeit, (2) kräftiges Springen, tätig sein, eine aktive Rolle spielen, eine wichtige Rolle spielen, wirksam sein
俄 (にわか): (1) plötzlich, mit einem Mal, auf einmal, auf einmal, überraschenderweise, (2) ohne weitere Vorbereitung
見出し (みだし): (1) Überschrift, Schlagzeile, Titel, (2) Register, Index, Inhaltsverzeichnis, (3) Schlagwort, Lemma, Wörterbucheintrag, Eintrag, (4) Herausfinden, Finden, (5) Auswahl
民主 (みんしゅ): Volkssouveränität
差し支え (さしつかえ): (1) Hindernis, Einwand, (2) anderweitige Verabredung, (3) Schwierigkeit, Störung, Unbequemlichkeit, (4) Einwand
ご無沙汰 (ごぶさた): langes Schweigen, langes Nicht-Besuchen, Säumigkeit (höfliche Form)
国籍 (こくせき): Staatsangehörigkeit, Nationalität
課税 (かぜい): Besteuerung, Steuerveranlagung, Steuer, Abgabe, Steuern auferlegen, Steuern erheben
下る (くだる): (1) hinuntergehen, hinuntersteigen, (2) voranrücken, (3) erteilt werden, gefällt werden, gegeben werden, (4) geringer sein, (5) Durchfall haben, (6) sich zurückziehen, sich zur Ruhe setzen, (7) sich ergeben, die Waffen strecken, kapitulieren
アンテナ: Antenne
圧縮 (あっしゅく): (1) Kompression, Kondensation, Verdichtung, Zusammendrücken, (2) Datenkompression, Kompression, (1) zusammendrücken, zusammenpressen, zusammenziehen, komprimieren, (2) kürzen (z.B. einen Text)
官庁 (かんちょう): (1) Behörde, Amt, (2) Staatsapparat, (3) Ministerium, (4) Amtsgebäude des Ministerpräsidenten
御数 (おかず): (1) Beilage (zum Reis), (2) Wichsvorlage (weil es nicht das Hauptgericht ist), Beilage, Nebengericht
慌てる (あわてる): (1) die Fassung verlieren, den Kopf verlieren, verwirrt werden, verlegen werden, (2) in Eile sein, hastig sein, sich übereilen, überstürzt handeln, sich überstürzen
取り消す (とりけす): zurücknehmen, widerrufen, rückgängig machen
失恋 (しつれん): unglückliche Liebe, enttäuschte Liebe, unerwiderte Liebe, verlorene Liebe, unglücklich lieben, sich in unglücklicher Liebe verzehren, vom Geliebten verlassen werden
餅 (もち): Mochi, Reiskuchen
不通 (ふつう): Unterbrechung
制作 (せいさく): Werk, Anfertigung, Produktion (eines Kunstwerkes, eines Filmes einer Schallplatte etc.), anfertigen (Kunstwerk, Film, Schallplatte etc.)
五味 (ごみ): Gomi, fünf Geschmacksarten (scharf, süß, salzig, bitter, sauer)
煙い (けむい): (1) rauchig, verraucht, (2) einen schwer atmen lassend, (3) vor Rauch schmerzend (in Augen, Nase, Hals)
不潔 (ふけつ): (1) Unsauberkeit, Schmutzigkeit, Unreinlichkeit, (2) Unmoral, Unanständigkeit, (1) sich nie waschen, immer schmutzig sein, (2) unmoralisch, unanständig
四角い (しかくい): viereckig
応援 (おうえん): (1) Unterstützung, Hilfe, Beistand, (2) Anfeuern, Ermunterung, (1) unterstützen, beistehen, Beistand leisten, Hilfe leisten, (2) ermutigen, anfeuern, aufmuntern
手ごろ (てごろ): Handlichkeit, Angemessenheit, Brauchbarkeit, mittlere Preislage, handlich, handgerecht, angemessen, brauchbar, praktisch, annehmbar, preiswert, vernünftig
下旬 (げじゅん): das letzte Drittel eines Monats, Zeit vom 21 bis zum Monatsende
散らす (ちらす):  (sich)verstreuen, zerstreuen
塞ぐ (ふさぐ): (1) schließen, verschließen, bedecken, (2) verstopfen, zustopfen, (3) versperren, deprimiert sein, betrübt sein
吐く (はく): (1) speien, spucken, sich übergeben, sich erbrechen, kotzen, (2) ausspeien, auswerfen, ausatmen, (3) von sich geben, äußern, ausdrücken, ausstoßen, (4) gestehen, zugeben
方言 (ほうげん): Dialekt, Mundart
熱する (ねっする): (1) erwärmen, heiß machen, (2) sich erhitzen, hitzig werden, (3) sich erregen
社会科学 (しゃかいかがく): Sozialwissenschaften
膨大 (ぼうだい): Anwachsen, (1) riesige Größe, (2) riesig, riesig, riesig groß, gigantisch, gewaltig
曲線 (きょくせん): Kurve, gekrümmte Linie, Bogen
蚊 (か): Mücke, Stechmücke, Schnake, Moskito, Culicidae
座布団 (ざぶとん): Kissen, japanisches Sitzkissen
温泉 (おんせん): (1) warme Quelle, heiße Quelle, (2) Thermalbad, Heilbad, Onsen
コース: (1) Kurs, Weg, Wanderweg, Bahn, (2) Rennbahn, (3) Laufbahn, Lebenslauf, (4) Kurs, Kursus, (5) Gang (eines Menüs), Ronald Harry Coase (brit. Wirtschaftswissenschaftler; 1910–; 1991 Nobelpreis für Wirtschaftswissenschaften)
電力 (でんりょく): (1) elektrische Kraft, elektrische Energie, (2) elektrische Leistung
実力 (じつりょく): (1) Fähigkeiten, Befähigung, Talent, Vermögen, Gelehrigkeit, Können, Leistung, (2) Gewalt, Initiative
ゼミ: Seminar, Seminarübung (Abk.)
薄める (うすめる): verdünnen, verwässern
中途 (ちゅうと): halbe Wegstrecke, auf dem Wege, auf halbem Weg, unterwegs, auf halbem Weg
文献 (ぶんけん): Literatur, Sekundärliteratur, Dokumente
酔っ払い (よっぱらい): Betrunkener
銘々 (めいめい): jeder einzelne, jeder, jedermann
客席 (きゃくせき): (1) Zuschauersitz, (2) Publikum, Zuschauer, (3) Fahrgastsitz, Passagiersitz
温帯 (おんたい): gemäßigte Zone
元 (もと): früher, ehemals, vormals, vorzeiten, einmal, früher, ehemalig
当たり前 (あたりまえ): (1) Selbstverständlichkeit, (2) selbstverständlich, natürlich, (3) etw. Normales, etw. Gewöhnliches, (4) normal, gewöhnlich, (1) selbstverständlich, natürlich, vernünftig, (2) gewöhnlich, gebräuchlich, üblich, normal
ローマ字 (ローマじ): lateinischer Buchstabe, Rōmaji, Lateinschrift
マイナス: (1) Minus, (2) negativer Pol, (3) Defizit, Minus
過失 (かしつ): (1) Fehler, Fehltritt, Missgriff, Versehen, Irrtum, (2) Fahrlässigkeit
特売 (とくばい): Sonderverkauf, Sonderangebot, zum Sonderpreis verkaufen
ロッカー: Schließfach, Spind
大ざっぱ (おおざっぱ): grob, oberflächlich, ungefähr, Grobheit, Oberflächlichkeit, grob, oberflächlich, ungefähr, in ungefährer Weise
伝わる (つたわる): (1) sich verbreiten, verbreitet werden, im Umlauf sein, (2) übermittelt werden, überliefert werden, (3) eingeführt werden, (4) geleitet werden, sich fortpflanzen, (5) entlang gehen
役目 (やくめ): Aufgabe, Rolle, Funktion, Pflicht, Amtspflicht
気配 (けはい): (1) Aufmerksamkeit, Wachsamkeit, (2) Konjunktur, Geschäftslage, (3) Marktpreis, Marktkurs, (1) Gefühl, Ahnung, Anzeichen, Zeichen, Andeutung, Anschein, (2) Konjunktur, Geschäftslage, Stimmung (Kanji sind Ateji)
役人 (やくにん): (1) Beamter, Inhaber eines öffentlichen Amtes, Bürokrat, (2) Bürokratie
食器 (しょっき): Essgeschirr, Geschirr, Besteck, Service
書き取り (かきとり): Diktat
屑 (くず): (1) Abfall, Lumpen, Müll, Trödel, (2) Abfall, Abschaum, wertloses Zeug, Ramsch
主人 (しゅじん): (1) Herr, Hausherr, (2) Gastgeber, (3) Hauswirt, Inhaber, Besitzer, (4) Dienstherr, Arbeitgeber, (5) Ehemann, Gatte
台詞 (せりふ): (1) Text, Rollentext, Text zu einer Rolle, (2) Worte, Rede, Serife (kleiner Abschlussstrich bei Schrifttypen), Rollentext, Text zu einer Rolle, Text, Text und Gesten, Rollentext (eines Schauspielers)
定規 (じょうぎ): Lineal
中間 (ちゅうかん): Mitte, Mittel, Zwischenraum, Zwischen-, dazwischen, in der Mitte, zwischen
照る (てる): scheinen
県庁 (けんちょう): Präfekturbehörde, Verwaltungsgebäude der Präfektur
夫妻 (ふさい): (1) Mann und Frau, (2) Herr und Frau …
プラスチック: Plastik, Kunststoff
忽ち (たちまち): (1) sofort, gleich, auf der Stelle, (2) im Handumdrehen, im Nu, im Augenblick, (3) plötzlich, auf einmal
レジャー: Freizeit
可愛がる (かわいがる): (1) lieben, lieb haben, zärtlich lieben, (2) verhätscheln
校庭 (こうてい): Schulhof, Schulgelände, Campus
学力 (がくりょく): Gelehrsamkeit, Lernfähigkeit, wissenschaftliche Begabung, Lernbegabung
仮名遣い (かなづかい): Verwendung von Kana, Schreibung in Kana, Kana-Rechtschreibung, Kana-Orthographie
胃 (い): Magen
天皇 (てんのう): (1) Tennō, Kaiser, (2) Regionalfürst, Tennō, Tennō, japan. Kaiser
付き合う (つきあう): (1) mit jmdm. Umgang haben, sich anfreunden, (2) jmdm. Gesellschaft leisten (beim Essen, beim Einkaufen)
突き当たり (つきあたり): Ende, Punkt, wo es nicht mehr weiter geht
演劇 (えんげき): (1) Schauspielkunst, Schauspielerei, (2) Theater, Theatervorstellung
先々月 (せんせんげつ): vorletzter Monat
夕日 (ゆうひ): (1) Abendsonne, untergehende Sonne, (2) Abend
引き分け (ひきわけ): Unentschieden (im Wettkampf)
明け方 (あけがた): Tagesanbruch, bei Tagesanbruch
目立つ (めだつ): auffallen, auffällig sein, ins Auge fallen, Aufmerksamkeit auf sich ziehen, die Blicke anziehen
殺気 (さっき): (1) Blutdurst, Mordlust, (2) feindliche Atmosphäre, (3) Frost, der die Vegetation verdorren lässt
血液 (けつえき): Blut
預かる (あずかる): (1) aufbewahren, achten auf, in Verwahrung haben, verwahren, verwalten, (2) in Obhut nehmen, die Sorge für etw. übernehmen, für etw. verantwortlich sein, (3) sich enthalten, sich zurückhalten
床の間 (とこのま): Tokonoma (traditionelle japanische Zimmernische)
