効果 (こうか): (1) Wirksamkeit, Effektivität, (2) Erfolg, Wirkung, Effekt, Resultat, Leistung, Ergebnis, Frucht, (3) Effekt, (4) Kōka (fast Yūkō), (5) Rechtsfolge
明確 (めいかく): Bestimmtheit, Ausdrücklichkeit, Exaktheit, Genauigkeit, bestimmt, präzise, ausdrücklich, fest umrissen, unzweideutig, klar, bestimmt, genau, präzise
芝居 (しばい): (1) Theaterstück, Theateraufführung, Schauspiel, Drama, (2) Schwindel, Schauspiel, abgekartetes Spiel
袖 (そで): (1) Ärmel, Flügel, Ärmelaufschlag, Manschette, (2) Flügel (eines Gebäudes), Seitenteil eines Schreibtisches
順 (じゅん): (1) Reihe, Reihenfolge, Ordnung, (2) Recht, Richtigkeit
仲間 (なかま): (1) Freund, Kollege, Gefährte, Kamerad, Genosse, Partner, (2) Gesellschaft, Clique, Gruppe, Kreis, Partei, Bande
香り (かおり): Kaori, (1) Duft, Geruch, Wohlgeruch, Aroma, (2) Blume (Wein)
禁止 (きんし): Verbot, Untersagung, verbieten, untersagen, Einhalt gebieten
火曜 (かよう): Dienstag (Abk.)
炎 (ほのお): Flamme, (1) Flamme, Lohe, (2) Erregung, Flammen der Leidenschaft (oder ähnlichem)
悪戯 (いたずら): (1) Unsinn, Alberei, Quatsch, Unsittlichkeit, (2) Streich, böser Scherz, Unfug, Schabernack
現象 (げんしょう): (1) Ereignis, Vorfall, Geschehen, Entwicklung, (2) Erscheinung (z.B. bei Kant), (3) Phänomen (z.B. bei Husserl)
名人 (めいじん): (1) Meister, Experte, Virtuose, (2) Meijin, Großmeister (früherer vom Edo-Shogunat an den Träger des höchsten Ranges vergebener Titel, 9. Dan; heute ein Meisterschaftstitel)
兎 (うさぎ): Hase, Kaninchen
断る (ことわる): (1) ablehnen, absagen, verweigern, abschlagen, ausschlagen, (2) sagen, mitteilen, um Erlaubnis bitten, sich entschuldigen, Ausreden machen, Entschuldigen vorbringen, sich rechtfertigen, sich verteidigen
文明 (ぶんめい): (1) Zivilisation, (2) Kultur, materielle Kultur, Bunmei (Ärabez.: 28.4.1469–20.7.1487)
支払う (しはらう): bezahlen
世間 (せけん): (1) Welt, Allgemeinheit, (2) Öffentlichkeit, Publikum, Leute, (3) Bekanntenkreis, jmds. Tätigkeitsgebiet
生 (なま): (1) roh, frisch, unvermischt, (2) live, (3) aus erster Hand, (4) Bargeld (Abk.), (5) Vorlautheit, Frechheit (Abk.), (6) Bier vom Faß (Abk.), roh
銃 (じゅう): Gewehr, Pistole
最中 (さいちゅう): inmitten, voller Gang einer Handlung, Höhepunkt einer Situation, mitten in
素敵 (すてき): großartig, herrlich, fabelhaft, fantastisch, prima, wunderbar, toll
文 (ぶん): (1) Satz, (2) Text, (3) Aufsatz
近代 (きんだい): (1) Gegenwart, die letzte Zeit, (2) Neuzeit, Moderne (in Japan seit der Meiji-Restauration), neuzeitlich, modern, neu
会員 (かいいん): Mitglied (eines Vereins), Angehöriger (eines Vereins)
意外 (いがい): Unerwartetes, Überraschung, Unerwartetheit, Überraschung, unerwarteterweise, überraschenderweise, zufällig, unerwartet, überraschend, unvorhergesehen, unverhofft, unvermutet, unvorhergesehen, zufällig, zu seiner Überraschung, unerwarteterweise, zufälligerweise
無事 (ぶじ): (1) Sicherheit, (2) Frieden, (3) Unversehrtheit, Wohlbehaltenheit, gute Gesundheit, (4) Langeweile, (1) sicher, (2) wohlbehalten, heil, unverletzt
塀 (へい): Mauer, Zaun
メモ: Notiz, Vermerk, Notizen machen, notieren
体育 (たいいく): (1) Leibeserziehung, Sport, Gymnastik, Körperertüchtigung, (2) Sport (als Unterrichtsfach)
使用 (しよう): (1) Gebrauch, Anwendung, Benutzung, Verwendung, Einsatz, Betrieb, (2) Beschäftigung, gebrauchen, Gebrauch machen, in Gebrauch nehmen, anwenden, zur Anwendung bringen, benutzen, verwenden, verwerten
試し (ためし): Versuch, Probe, Prüfung
大半 (たいはん): mehr als die Hälfte, der größere Teil, der größte Teil, die Mehrzahl
金 (きん): (1) Gold (Zeichen: Au für lat. Aurum), (2) Geld, (3) Goldmünze, (4) Geldbeträgen vorangestelltes Zeichen, (5) Karat (Maß der Feinheit einer Goldlegierung), (6) goldene Farbe, Goldfarbe, (7) Goldgeneral, Goldfeldherr, Gold (Name eines Steines), (8) Metall, viertes der fünf Elemente, (9) Freitag (Abk. für kinyō金曜), (10) Eier, Hoden, Testikel
偶々 (たまたま): (1) selten, gelegentlich, (2) zufällig, durch Zufall
谷 (たに): Tani, (1) Tal, Schlucht, (2) Wellental
現在 (げんざい): (1) Gegenwart, Heute, Jetzt, (2) gegenwärtig, aktuell, (3) Aktualität, aktuelle Situation, (4) Präsenz, Existenz direkt vor den Augen, (5) offensichtlich, unbestreitbar, (6) tatsächlich, (7) die gegenwärtige Welt, (8) Präsens
期間 (きかん): Zeitspanne, Zeitraum, Zeitdauer, Zeit, Laufzeit, Frist
手段 (しゅだん): (1) Mittel, Weg, Maßnahme, (2) Gerät, (3) Instrument
脇 (わき): (1) Seite, (2) anderer Ort, woanders, anderswo, (3) Achsel, Achselhöhle, (4) oberer Innenarm, (5) Waki, Nebenrolle, Nebendarsteller, (6) Folgevers, zweiter Vers (bei Renga)
宅 (たく): (1) Haus, Wohnung, (2) Zuhause, Heim, (3) mein Ehemann
傾向 (けいこう): (1) Tendenz, Trend, Richtung, Zug, Neigung, Hang, Anlage, Disposition, (2) Tendenz, (3) (insbes.)Linkstendenz, (4) Neigung (z.B. bei I. Kant), (5) Tendenz
軍 (ぐん): (1) Armee, Heer, Truppen, (2) Militär…, Kriegs…, (3) Streitkräfte, Heer, Marine und Luftstreitkräfte, (4) Division, (5) Division von 12.500 Soldaten (während der Zhou-Dynastie)
拡大 (かくだい): (1) Ausdehnung, Ausweitung, (2) Vergrößerung, (1) vergrößern, ausdehnen, ausweiten, erweitern, verstärken, (2) vergrößern
政府 (せいふ): Regierung, Verwaltung, Ministerium, Kabinett
タオル: (1) Handtuch, Badetuch, (2) (mn) Frottee
芽 (め): Knospe, Keim, Spross, Auge (Knospenansatz)
売れる (うれる): (1) sich verkaufen, sich gut verkaufen lassen, guten Absatz finden, (2) für … verkauft werden, (3) zu verkaufen sein, absatzfähig sein, (4) sich einen Namen machen, populär werden, berühmt werden, überall bekannt sein
ラケット: Schläger
診察 (しんさつ): ärztliche Untersuchung, Diagnose, ärztlich untersuchen, eine Diagnose stellen
引退 (いんたい): Rücktritt (aus einem Amtaus dem aktiven Dienst), zurücktreten
泉 (いずみ): Quelle, Brunnen, Izumi
演技 (えんぎ): (1) Darstellung, Spiel, Aufführung, (2) Schauspielkunst, (3) Technik, Turnfigur, (4) absichtliches Schauspiel (z.B. um jmdn. anderen zu manipulieren), (1) aufführen, vorführen, darstellen, vortragen, (2) spielen, (3) eine Show abziehen
鉄 (てつ): Eisen, Stahl, eisern
結局 (けっきょく): (1) (2) 
平等 (びょうどう): Gleichheit, Gleichberechtigung, Parität, Egalität, Égalité, Gleichheit, Gleichberechtigung, Egalität, Égalité, gleich, gleichberechtigt, ebenbürtig, paritätisch, unparteiisch, unterschiedslos, gleich, in gleicher Weise, gleich
似合う (にあう): jmdm. stehen, gut zusammenpassen, passen zu
仮令 (たとえ): auch wenn, selbst wenn, obgleich, obwohl, obschon
たっぷり: (1) reichlich, gut, genügend, voll, völlig, in Hülle und Fülle, (2) sehr, außerordentlich, ausgesprochen, rechlich, genügend
製品 (せいひん): Produkt, Erzeugnis, Fabrikat, Artikel, Güter
宿泊 (しゅくはく): Unterkunft, Übernachtung, Einquartierung, Logieren, Unterkommen, übernachten, sich einquartieren, unterkommen, logieren
分 (ぶん): (1) Anteil, Teil, (2) Portion
プラス: (1) Plus, (2) Anode, (3) Vorteil, Gewinn, (1) addieren, (2) einen Vorteil bringen, einen Beitrag leisten, positiv
協力 (きょうりょく): Zusammenarbeit, Mitwirkung, Kooperation, zusammenarbeiten, mitwirken, kooperieren
触れる (ふれる): (1) berühren, anfassen, in Berührung kommen, (2) fühlen, wahr nehmen, (3) übertreten, verletzen, (4) erwähnen, sich beziehen auf, (5) bekannt machen
望む (のぞむ): (1) hoffen, wünschen, wollen, sollen, verlangen, sich sehnen, trachten, (2) erwarten, (3) überblicken, Überblick haben, Aussicht bieten übersehen
要するに (ようするに): kurz, kurz und bündig, kurzum, um es kurz zu sagen
不満 (ふまん): Unzufriedenheit, Missfallen, Unmut, Missvergnügen, Widerwille, Unwille, (1) unzufrieden, nicht befriedigend, schlecht, (2) widerwillig
代表 (だいひょう): (1) Vertreter, Repräsentant, Delegierter, Stellvertreter, (2) Stellvertretung, Repräsentation, vertreten, repräsentieren (Firma, Regierung etc.)
稼ぐ (かせぐ): (1) seinen Unterhalt verdienen, (2) hart arbeiten, (3) sich anstrengen, (4) verdienen, gewinnen, erwerben
作品 (さくひん): (1) Werk, (2) Kunstwerk
塔 (とう): Turm, Pagode, Kirchturm
行儀 (ぎょうぎ): Manieren
単に (たんに): nur, bloß, einfach
予報 (よほう): Prognose, Vorhersage, vorhersagen
命令 (めいれい): (1) Befehl, Anweisung, Anordnung, Dekret, Gebot, Order, Weisung, (2) Befehl, (3) Verfügung, befehlen, einen Befehl geben
数える (かぞえる): zählen, rechnen
臭い (くさい): (1) stinkend, übelriechend, verdorben (riechen), faul, moderig, (2) nach … riechend, stinken nach …, (3) übertrieben, unnatürlich (Schauspiel)
組む (くむ): (1) verflechten, verschränken, kreuzen, (2) zusammensetzen, zusammenbinden, zusammenfügen, konstruieren, bilden, (3) setzen (Schrifttypen), (4) ringen, (5) (eine Gruppe) bilden, sich zusammentun, gemeinsam handeln
医療 (いりょう): ärztliche Behandlung
印象 (いんしょう): (1) Eindruck, Sinneseindruck, (2) Gefühlseindruck, Empfindung, (3) Impression
帯 (おび): (1) Gürtel, Gurt, Leibbinde, Obi, Kimonogürtel, Schärpe, (2) Across-the-board-Programm, Programm mit festem Sendeplatz an mehreren Tagen in der Woche, (3) Papierstreifen, Streifband, Bauchbinde
出会う (であう): (1) treffen, begegnen, (2) stoßen (auf), zusammenstoßen, zusammentreffen
猿 (さる): (1) Affe, Primat (mit Ausnahme des Menschen), (2) gerissene Person (als Beschimpfung verwendet), (3) Türriegel, (4) Bambusbolzen zum Verstellen des Kesselhakens über der Feuerstelle, (5) Prostituierte in einem Badehaus (Edo-Zeit), (6) Detektiv, Geheimpolizist, Spion (in der Edo-Zeit), (7) eine Art Verzierung für Drachen aus einem Stück Papier, (8) eine Art Affenpuppe
影響 (えいきょう): Einfluss, Effekt, Wirkung, Auswirkung, Nachwirkung, beeinflussen, Einfluss ausüben, wirken
減らす (へらす): (1) vermindern, verringern, reduzieren, verkleinern, (2) abkürzen, verkürzen, kürzen, (3) jmdn. schlecht machen, jmdn. heruntermachen, jmdn. herabsetzen, jmdn. herabwürdigen
冠 (かんむり): Krone, Krone, erster Rang, (1) Krone, (2) Kanmuri (bei Zeremonien z.B. von Priestern getragene Kopfbedeckung; im Gegensatz zur Eboshi), (3) Kanmuri-Radikal (wie der Gras-Radikal oder u・kanmuri), (4) Bedecken der Sponsorennamen z.B. bei Sportveranstaltungen, Kanmuri
眺め (ながめ): Aussicht, Sicht, Ausblick, Blick, Panorama, Prospekt, Landschaft
感じ (かんじ): (1) Gefühl, Empfindung, (2) Eindruck, Stimmung
カー: Auto, Edward H. Carr (engl. Diplomat und Politologe; 1892–1982), John Kerr (brit. Physiker; 1824–1907)
出版 (しゅっぱん): Herausgabe, Veröffentlichung, Publikation, Verlag, Edition, herausgeben, veröffentlichen, publizieren, erscheinen lassen
単純 (たんじゅん): Einfachheit, Schlichtheit, Einfachheit, einfach, schlicht, primitiv, einfältig, naiv
販売 (はんばい): Verkauf, Vertrieb, Absatz, Umsatz, verkaufen, vertreiben, absetzen, Handel treiben, handeln
人間 (にんげん): (1) Mensch, Person, Sterblicher, menschliches Wesen, Erdenbürger, (2) Persönlichkeit, Charakter, Geist, (3) Welt der Menschen, Menschengeschlecht, Menschheit
相続 (そうぞく): Erbschaft, Vererbung, Erbfolge, erben, eine Erbschaft machen, das Erbe antreten
月曜 (げつよう): Montag
維持 (いじ): Instandhaltung, Unterhaltung, Wartung, Aufrechterhaltung, Erhaltung, Bewahrung, Unterstützung, aufrechterhalten, bewahren, erhalten, instand halten, unterhalten, unterstützen, wahren
順調 (じゅんちょう): günstiger Verlauf, glattes Fortkommen, Gedeihen, günstiger Verlauf, zufrieden stellender Verlauf, glattes Vorankommen, günstig, gut, glatt, ruhig, günstig, ohne Stockung, glatt, gut, ruhig
僅か (わずか): wenig, gering, geringfügig, knapp, klein, kümmerlich, kurz, spärlich, winzig, wenig, gering
伝統 (でんとう): Tradition, Überlieferung, Brauch, Herkommen, Schlendrian
芝生 (しばふ): Rasen, Wiese, Gras
事件 (じけん): (1) Vorfall, Angelegenheit, Begebenheit, Ereignis, Zwischenfall, Affäre, (2) (oftmals euphemistisch für alle möglichen unangenehmen Vorfälle; z.B.)Skandal, Erpressungsfall, Revolte, Katastrophe, Massaker
唯一 (ゆいいつ): Einzigartigkeit, Beispiellosigkeit, einzige, alleinige
裏切る (うらぎる): (1) verraten, hintergehen, betrügen, (2) enttäuschen, missbrauchen
詩人 (しじん): Dichter
止す (よす): aufhören, aufgeben
深刻 (しんこく): Ernst, Ernsthaftigkeit, ernst, akut, bedenklich
機械 (きかい): (1) Instrument, Gerät, Werkzeug, (2) (seltener)Maschine, Apparat, (1) Maschine, Mechanismus, Apparat, Gerät (erhält seine Kraft meist von außen und nicht vom Menschen), (2) (seltener)Instrument, Gerät, Werkzeug
微笑む (ほほえむ): lächeln
組合 (くみあい): Gewerkschaft, Genossenschaft, Lehrerverband, Zunft
疲れ (つかれ): Müdigkeit, Ermüdung, Erschöpfung, Ermattung, Abspannung
所が (ところが): (1) aber, jedoch, trotzdem, (2) nun, wohl, übrigens, nebenbei
申し訳 (もうしわけ): (1) Entschuldigung, Abbitte, (2) Ausrede, Erklärung, Rechtfertigung, Förmlichkeit
ですから: (1) deshalb, daher, also, darum, demnach, somit, (2) da, denn, weil
笑顔 (えがお): lächelndes Gesicht, fröhliches Gesicht
解決 (かいけつ): Lösung, Beseitigung, Regelung, Ausgleich, Schlichtung, Entscheidung, Abrechnung, lösen, schlichten, ausmachen, ausgleichen, beseitigen, wegräumen
幕 (まく): (1) Bühnenvorhang, Vorhang, (2) Akt, Abschnitt, Aufzug (eines Theaterstückes), (3) (Zählwort für) Akte,  Abschnitte,  Aufzüge, (4) Auftritt, (5) Fallen des Vorhangs, Ende, Schluss, (6) Makuuchi (Sumō-Ringer der höchsten Klasse)
原 (はら): Feld, Wiese, Ebene, Wildnis, Hara
両替 (りょうがえ): Geldwechsel, Geld wechseln
同一 (どういつ): Gleichheit, Identität, Einförmigkeit, Einheitlichkeit, Eintönigkeit, Gleichartigkeit, derselbe, der nämliche, ein und derselbe, identisch, gleich
単なる (たんなる): nur, bloß
捕まる (つかまる): (1) gefangen werden, verhaftet werden, gefasst werden, (2) sich festhalten
温暖 (おんだん): Wärme, warm, mild
滅多に (めったに): kaum, selten, so gut wie nie (mit Verneinung)
自動 (じどう): Eigenbewegung, Automatik, (1) automatisch, (2) intransitiv, nicht zielend, ziellos
硬貨 (こうか): (1) Hartgeld, Münze, (2) harte Währung
風景 (ふうけい): Landschaft, Aussicht, Ausblick, Szenerie
加減 (かげん): (1) Addition und Subtraktion, (2) Grad, Maß, (3) Befinden, körperliches Befinden, Gesundheitszustand, (4) Ausmaß, Verhältnis, (5) Regelung, Einstellung, (6) Einfluss, Einwirkung, (7) Würzen, (1) addieren und subtrahieren, hinzuzählen und abziehen, (2) regeln, regulieren, (3) abmessen, salzen, (4) würzen
友情 (ゆうじょう): Freundschaft, Freundlichkeit
次々 (つぎつぎ): einer nach dem anderen, hintereinander, nacheinander, ununterbrochen
燃える (もえる): (1) brennen, glühen, Feuer fangen, flammen, lodern, lohen, (2) glühend rot sein, (3) glühen vor …
マーケット: Markt
得る (える): (1) gewinnen, erwerben, bekommen, finden, (2) können, (1) jagen, erbeuten, fangen, (2) wegnehmen, rauben, sich aneignen
何も (なにも): (1) nichts, (2) überhaupt nicht, in keiner Weise
位 (くらい): (1) Rang des Tennō, (2) Tennō, (3) Hofrang, Rang, Stellung, Grad, Klasse, (4) Stellung in einer Gruppe, (5) Stelle, (6) Stil eines Werkes, (7) Rang in einer Kunst
主に (おもに): hauptsächlich, vor allem, größtenteils, vorwiegend
注ぐ (つぐ): einschenken, gießen, auffüllen
詰める (つめる): (1) stopfen, füllen, einpacken, (2) verstopfen, (3) kürzen, verkürzen, (4) eng stellen, zusammenrücken, (5) die Kosten kürzen, sparen, einsparen, (6) versperren, nicht durchlassen, (7) sich konzentrieren, die Konzentration zusammennehmen, (8) zum Äußersten gehen, (9) schachmatt setzen, (10) den Atem anhalten, (11) (nach Verb in Ren’yō・kei) ohne Pause … tun, unaufhörlich … tun, (12) gründlich … tun, (13) … tun, um den Gegner in Schwierigkeiten zu bringen, (14) in die Enge treiben, stellen, in Schach halten
調査 (ちょうさ): Untersuchung, Nachforschung, Anfrage, Erkundung, Prüfung, Umfrage, Erhebung, untersuchen, anfragen, erforschen, erkunden, ermitteln, nachforschen, nachfragen, prüfen, eine Untersuchung vornehmen, eine Umfrage abhalten, einen Zensus durchführen
大統領 (だいとうりょう): Präsident, Staatspräsident, Bundespräsident
畑 (はたけ): Feld, Trockenfeld, Acker, Gemüsegarten, (1) Feld, Trockenfeld, Acker, (2) Fachgebiet, Hata
単位 (たんい): (1) Einheit, Maßeinheit, Messwert, (2) Punkteinheit, Anrechnungspunkt
法 (ほう): (1) Gesetz, Recht, (2) Regel, (3) Methode, (4) Etikette, (5) Vernunft, (6) Buddhas Lehre, (mn) Dharma, (7) Modus, Aussageweise
センター: (1) Zentrum, (2) Centerfield, (3) Centerfielder, (4) Mitte, (5) Mittel… (‑Stürmer etc.)
革 (かわ): Fell, Pelz
ノー: nein (als verstärkte Verneinung benutzt)
移す (うつす): (1) verlegen, umstellen, (2) (Personal) versetzen, (3) die Richtung ändern, (4) jmd.anstecken, eine Krankheit weitergeben, (5) (Zeit) verbringen, (6) (Farbe od. Geruch auf eine andere Sache) übertragen
講演 (こうえん): Vortrag, Rede, Vorlesung, einen Vortrag halten
畑地 (はたち): Ackerland
動かす (うごかす): (1) bewegen, rühren, regen, rücken, verrücken, (2) in Betrieb nehmen, in Gang setzen, in Bewegung setzen, (3) verändern, beeinflussen, bedienen, erschüttern, rütteln, (4) versetzen, transferieren
昼食 (ちゅうしょく): Mittagessen
辺り (あたり): (1) Nachbarschaft, Gegend, Umgebung, Nähe, (2) die anwesenden Leute, (3) um …, ungefähr, Nähe, Nachbarschaft, Gegend
上 (かみ): (1) der obere Teil, das Obere, das Oben, (2) Oberlauf, (3) Obrigkeit, Regierung, Behörde
方々 (かたがた): Herrschaften
軒 (のき): (1) Dachtraufe, Traufe, Dachvorsprung, (2) Vordach
旅 (たび): Reise, Ausflug, Tour
速度 (そくど): Geschwindigkeit, Tempo, Schnelligkeit
黙る (だまる): (1) schweigen, den Mund halten, nicht sprechen, verstummen, still schweigen, (2) nicht Bescheid sagen, nicht um Erlaubnis fragen
能力 (のうりょく): Fähigkeit, Talent, Begabung, Kapazität, Können, Vermögen, Kraft, Anlage
就く (つく): (1) besteigen (den Thron), (2) übereinstimmen, beruhen auf …, anpassen, (1) ins Bett gehen, (2) eine Stellung antreten, (3) sich auf den Rückweg machen, heimgehen, (4) bei jmdm. lernen, bei jmdm. Unterricht haben
化学 (かがく): Chemie, Chemie (diese Aussprache wird verwendet, um den Unterschied der Standard-Lesung kagaku zum Homonym kagaku科学 mit der Bedeutung Wissenschaft klar zu machen), chemisch
太陽 (たいよう): (1) Sonne, (2) Hoffnung, Hoffnungsstrahl
条件 (じょうけん): (1) Bedingung, Voraussetzung, Vorbehalt, (2) Bestimmung, Klausel
ユーモア: Humor, Spaß
企業 (きぎょう): (1) Unternehmen, Unternehmung (im Sinne von etw., das unternommen wird und im Sinne von Betrieb), (2) Geschäft, Gesellschaft
株 (かぶ): (1) Baumstumpf, (2) Stamm, (3) gewerbliches Sonderrecht, (4) gehandelter Familienname, Posten o.Ä, (5) Aktie, (6) Aktienhandel, (7) jmds. besondere Stärke, jmds. Spezialität, jmds. Steckenpferd, (8) Wert einer Person für seine Firma, (9) Stamm von Bakterien, Zellkulturen etc
定期 (ていき): (1) bestimmte Zeit, bestimmte Zeitdauer, festgesetzte Zeit, festgesetzte Zeitdauer, (2) Formatlineal (bei Textverarbeitung), (3) Zeitfahrkarte (Abk.), regelmäßig, periodisch, regelmäßig, periodisch, Zeit…, Termin…
不平 (ふへい): (1) Unzufriedenheit, Missmut, Missfallen, Unruhe, (2) Unebenheit
区別 (くべつ): Unterscheidung, Unterschied, Differenzierung, Differenz, unterscheiden, einen Unterschied machen
国境 (こっきょう): Landesgrenze, Grenze, Demarkationslinie
戦い (たたかい): (1) Kampf, Schlacht, Gefecht, Krieg, (2) Streit, Konflikt, Kampf, Zwist, (3) Wettkampf, Wettbewerb, Spiel, (4) Kampagne
土産 (みやげ): (1) lokales Souvenir, Reisemitbringsel, (2) Geschenk
当たる (あたる): (1) treffen, schlagen, stoßen, (2) berühren, streifen, (3) sich bewahrheiten, sich bestätigen, (4) führen, (5) gewinnen, das große Los ziehen, (6) Erfolg haben, gelingen, (7) zugewiesen werden, (8) ausgesetzt sein, bescheinen lassen, sonnen, (9) unternehmen, übernehmen, in die Hand nehmen, (10) sich entgegensetzen, widerstehen, die Stirn bieten, Widerstand leisten, (11) liegen, sich befinden, (12) prüfen, nachschlagen, (13) entsprechen, gleichwertig sein, (14) verdienen, wert sein, würdig sein, (15) infizieren, schlecht bekommen, (16) drücken (Schuhe), (17) unfreundlich behandeln, hart angehen, (18) einen Fleck bekommen, (19) (als Ersatz für Tabuworte der Händler) reiben, zermalen, (20) rasieren
器用 (きよう): (1) Geschicktheit, Geschicklichkeit, Gewandtheit, Fingerfertigkeit (besonders mit feinen Sachen oder mit unterschiedlichen Sachen), (2) Klugheit, Erfindungsreichtum (in seinen Handlungen), geschickt, gewandt, praktisch, gelenkig, fingerfertig
持ち上げる (もちあげる): (1) heben, hochheben, emporheben, (2) in den Himmel heben, rühmen, preisen
輪 (わ): (1) Rad, (2) Ring, Kreis, Zirkel, Öse, Glied, (3) Fassband, (4) Schlinge, Schleife
トンネル: (1) Tunnel, (2) Ball, der zwischen den Beinen hindurch geht (übertr.; ugs.), einen Ball durch Beine rollen lassen
皿 (さら): Teller, Schüssel, Schale, Platte, Untertasse
明かり (あかり): (1) Licht, Schein, Helligkeit, heller Glanz, (2) Licht, Lampe, (3) Beweis (für die Unschuld)
越える (こえる): übersteigen, übertreffen, überschreiten, über … gehen, (1) überschreiten, überqueren, passieren, überwinden (einen örtlichen Punkt), (2) überschreiten (einen Zeitpunkt), (3) einen Standard übersteigen, (4) überschreiten, übersteigen, übertreffen (eine Zahl), (5) eine Regel übertreten, gegen eine Regel verstoßen, gegen die Ordnung verstoßen
今回 (こんかい): diesmal, dieses Mal, jetzt kürzlich, nächstes Mal, das nächste Mal, bald, nächstens, neulich, kürzlich
伸ばす (のばす): (1) ausdehnen, ausbreiten, (2) gerade biegen, Teig ausrollen, ausstrecken, (3) gerade walzen, ausbügeln, glätten, (4) Haare wachsen lassen, Bart stehen lassen, (5) entfalten (sein Talent), (1) verlängern, länger machen, strecken, ausstrecken, ausrollen, auswalzen, ausdehnen, (2) verschieben, aufschieben, zögern, Zeit ausdehnen, (3) entwickeln, expandieren, wachsen lassen, (4) anrühren, verlängern, strecken (Suppe etc.), (5) zu Boden schlagen, (1) strecken, ausstrecken, ausdehnen, ausbreiten, verlängern, gerade machen, (2) entfalten, entwickeln
種類 (しゅるい): Art, Sorte, Gattung
宗教 (しゅうきょう): Religion, Glaube
向く (むく): (1) das Gesicht zuwenden, (2) in eine Richtung zeigen, (3) gerichtet sein auf …, sich richten …, sich wenden, entgegensehen, (4) geeignet sein für …, angemessen sein, passen, jmdm liegen, dem Geschmack entsprechen, (5) sich schicksalhaft ergeben, (6) gehorchen, unterwürfig sein
氏 (し): (1) Familie, (2) Familienname, Herr
見送り (みおくり): (1) Abschiednehmen, Begleitung, (2) Verschieben
可也 (かなり): ziemlich, beträchtlich, recht, verhältnismäßig
繰り返す (くりかえす): (1) wiederholen, sich wiederholen, immer wieder machen, (2) noch einmal herumwickeln
暮らし (くらし): (1) Lebensunterhalt, Unterhalt, Auskommen, Leben, Haushalt, (2) Lebensumstände, Lebensverhältnisse
稍 (やや): etwas, ein wenig, ein bisschen, ziemlich
発達 (はったつ): Entwicklung, Fortschritte, Vergrößerung, Wachstum, sich entwickeln, Fortschritte machen, sich vergrößern, wachsen
左右 (さゆう): (1) links und rechts, die rechte und die linke Seite, die Rechte und die Linke, (2) Beeinflussung, entscheidende Beeinflussung, Entscheidung, beeinflussen, einwirken, Einfluss haben, beherrschen, in Gewalt haben, das Heft in der Hand haben
混雑 (こんざつ): (1) Gewühl, Getümmel, Gedränge, Rummel, Trubel, (2) Verkehrsstörung, Verkehrsstauung, (3) Durcheinander, Wirrwarr, Unordnung, Verwirrung, überfüllt sein, drängen, wimmeln, sich zusammendrängen, schwärmen
述べる (のべる): erwähnen, äußern, aussprechen, erläutern
スキー: Ski, Skifahren
可愛らしい (かわいらしい): süß, lieb, entzückend, nett, klein
覚める (さめる): (1) wach werden, erwachen, aufwachen, zu sich kommen, (2) nüchtern werden, (3) zu Sinnen kommen, aus einer Illusion oder einem Wahn erwachen, (4) ruhig werden
便 (びん): (1) Post, Zustellung, Auslieferung, (2) Zustellungsweise, (3) Gelegenheit
評価 (ひょうか): (1) Bewertung, Veranschlagung, (2) Schätzung, Abschätzung, (3) Würdigung, (4) Evaluierung, (1) abschätzen, einschätzen, schätzen, beurteilen, bewerten, taxieren, veranlagen, veranschlagen, würdigen, (2) evaluieren
刈る (かる): schneiden, abschneiden, stutzen, scheren, mähen, abernten (Haare od. Stängel, Äste und Zweige von Pflanzen)
綿 (わた): Baumwolle, Watte
棒 (ぼう): (1) Stab, Stock, Knüppel, (2) Stock fürs Stockfechten, (3) Stockfechten, (4) Strich, Linie, Gerade, (5) Steifheit der Beine (z.B. wegen Überanstrengung), (6) Geradheit, Vereinfachung, (7) Fortsetzung, (8) zur Ermahnung verwendeter Stock, (9) Ermahnung mit dem Stock
実験 (じっけん): Experiment, Test,  (wissenschaftlicher)Versuch, Probe, experimentieren, Versuche anstellen, Tests machen, Proben ausführen
酒 (さけ): Sake, Reiswein, Alkoholika (Aussprache nach einer chin. Deckbezeichnung), (1) Alkoholika, (2) Reiswein, Sake, (1) Alkoholika, (2) Reiswein, Sake, (1) Alkohol, alkoholisches Getränk, Alkoholia, (2) Sake, japanischer Reiswein (Alkoholgehalt 12 bis 16 Volumenprozent; wird oft warm getrunken)
灰 (はい): Asche, Schlacke, Zinder
最低 (さいてい): niedrigst, geringst, Minimal…, Mindest…, Tiefst…, niedrigst, geringst, minimal
冒険 (ぼうけん): Abenteuer, gewagtes Unternehmen, Risiko, Gefahr, wagen, ein Wagnis eingehen
局 (きょく): (1) Amt, Dienststelle, Abteilung, Behörde, (2) zuständige Behörde, Amtsstelle, Autorität, (3) Rundfunkstation, Station, Fernsehanstalt (Abk. für Einrichtungen, die mit …kyoku bezeichnet werden), (4) Angelegenheit, (5) Pflicht, (6) Lage, Situation, (7) eine Partie, ein Spiel
下ろす (おろす): (1) herablassen, herunternehmen, hinunterbringen, (2) herunterholen, abladen, absetzen, aussteigen lassen, (3) auflegen (Hörer), (4) herunterlassen (Vorhang), niederholen (Segel), (5) schließen (Geschäft), (6) vor Anker gehen, (7) aussteigen lassen (aus einem Fahrzeug), (8) abtreiben (Fötus), (9) abschneiden, (10) abheben, anlegen, investieren (Geld), (11) zum ersten Mal benutzen, (12) mit dem Reibeisen reiben
専攻 (せんこう): Fach, Fachgebiet, Hauptfach, Fachstudium, sich auf … spezialisieren
値 (あたい): (1) Preis, (2) Wert, (3) Zahlenwert, Wert, (4) Größe, Preis, Kosten
土 (つち): (1) Erde, Boden, Schlamm, Ton, (2) Grund
確かめる (たしかめる): sich vergewissern, sich versichern, bestätigen
キッチン: Küche, Chitin (hornähnlicher Stoff im Panzer der Gliederfüßer), Joseph Kitchin (brit. Unternehmer u. Statistiker; 1861–1932), Küche
馬 (うま): (1) Pferd, Ross, Gaul, Hengst, Stute, Wallach, Fohlen, Füllen, Pony, (2) Bock, Gestell, Leiter, (3) jmd., der dem Gast nach Hause folgt, um die Rechnung zu kassieren, (4) Pferd
女優 (じょゆう): Schauspielerin
地位 (ちい): Stellung, Rang, Position, Posten, Stand, Stelle
済ませる (すませる): (1) beenden, beendigen, fertig werden, fertig machen, erledigen, (2) auskommen, vorlieb nehmen, sich behelfen, entbehren können
その内 (そのうち): (1) bald, demnächst, gleich, binnen kurzem, in wenigen Tagen, demnächst, (2) inzwischen, in der Zwischenzeit, mittlerweile, unterdessen, (3) im Laufe der Zeit, (4) darunter
支出 (ししゅつ): Ausgabe, Auslagen, Aufwand, Kosten, Verausgabung, ausgeben, aufwenden, Kosten bestreiten, verausgaben
疑う (うたがう): (1) zweifeln, bezweifeln, in Frage stellen, misstrauen, (2) einen Verdacht hegen, Verdacht schöpfen, verdächtigen, (3) misstrauen
火災 (かさい): Feuer, Brand, Brandunglück, Feuersbrunst
パス: (1) Pass, Ausweis, (2) Monatskarte, (3) Passierschein, Freikarte, (1) Bestehen (einer Prüfung), (2) Pass, Zuspiel, (1) Passen (beim Kartenspiel), (2) Verzicht, Ausschlagen (eines Angebotes), Greifzirkel, Tasterzirkel (Abk.), Pfad, Dateipfad, Octavio Paz (mexikanischer Schriftsteller; 1914–1998), (1) bestehen (eine Prüfung), (2) einen Pass spielen, passen, abgeben, zuspielen
吸収 (きゅうしゅう): (1) Aufsaugen, Absorption, Einsaugen, (2) Resorption, einsaugen, aufsaugen, absorbieren, einziehen, aufnehmen, zu eigen machen, sich einverleiben
桜 (さくら): (1) Kirschbaum, Kirsche, Prunus, (2) Kirschblüte, (3) Kirschfarbe, Blassrosa, Hellrot (Abk. für sakura iro), (4) Pferdefleisch
実行 (じっこう): (1) Ausführung, Ausübung, Erfüllung, Realisierung, Verwirklichung, (2) Durchlauf, Ausführung, (1) ausführen, durchführen, verwirklichen, in die Tat umsetzen, realisieren, erfüllen, handeln, vollführen, vollziehen, (2) laufen lassen, durchführen
直ちに (ただちに): (1) sogleich, sofort, unverzüglich, ohne Verzug, unmittelbar, direkt, (2) nicht unbedingt (mit Verneinung)
損害 (そんがい): Schaden, Verlust, Nachteil, Verluste
ドレス: Dress, Kleid, Kleidung
完了 (かんりょう): (1) Vollendung, Abschluss, Fertigstellung, (2) Perfekt, Vergangenheit, vollenden, fertig machen, abschließen
突然 (とつぜん): plötzlich, unerwartet, plötzlich, unerwartet, unerwarteter Weise, plötzlich, unerwartet
境 (さかい): (1) Grenze, (2) Ort, Stelle, Platz, (3) Zustand, Situation, (4) Stadium, Sakai, (1) Grenze, Grenzlinie, (2) Trennlinie, (3) Ort, Stelle, Platz, (4) Umstände, Lage, Situation
演説 (えんぜつ): (1) Ansprache, Rede, (2) Erklärung, Erläuterung (eines Dogmas, einer Bedeutung etc.), eine Rede halten, eine Ansprache halten, das Wort an eine Versammlung richten
余分 (よぶん): (1) Überschuss, Übermaß, Zuviel, Rest, (2) etw. Zusätzliches, überschüssig, überflüssig, extra, zusätzlich, zusätzlich, überschüssig, zu viel, überflüssig
後者 (こうしゃ): (1) der Letztere (von zwei Erwähnten), dieser, (2) der später Gekommene, Person aus der kommenden Generation, dieser, letzterer
作物 (さくもつ): (1) Feldfrüchte, Kulturpflanze, Kulturgewächs, Getreide, landwirtschaftliche Produkte, Ernte, (2) Werk, Kunstwerk
共通 (きょうつう): Gemeinsamkeit, gemeinsame Eigenschaft, etw. gemein haben, in etw. eine Gemeinsamkeit haben, gemein, gemeinsam, gemeinschaftlich, allgemein
違いない (ちがいない): bestimmt, sicher, sicherlich, ohne Zweifel, zweifellos
目標 (もくひょう): (1) Ziel, Zielscheibe, Angriffsziel, Merkzeichen, (2) Absicht, Ziel
一般 (いっぱん): (1) Normalität, Gewöhnlichkeit, Allgemeinheit, Üblichkeit, (2) Gleichheit, Unterschiedslosigkeit, allgemein, gewöhnlich, üblich, gebräuchlich
楽 (らく): (1) Behaglichkeit, Bequemlichkeit, Erleichterung, (2) Zuneigung, Liebe, (3) Einfachheit, Leichtigkeit, Mühelosigkeit, (4) Raku-Ware, Raku・yaki, Raku (handmodellierte und bei niedriger Temperatur gebrannte Töpferware; Abk. für raku・yaki楽焼き), (5) letzter Tag (eines Sumō-Turniers, einer Theateraufführung), (1) bequem, behaglich, gemütlich, komfortabel, angenehm, (2) leicht, einfach, (1) bequem, komfortabel, (2) leicht, einfach
クリーム: (1) Creme, Hautcreme, (2) Sahne
党 (とう): (1) Partei, (2) Clique
チーズ: Käse, Quark
害 (がい): Schaden, Schädigung, Leid, Unheil, Harm
希望 (きぼう): (1) Wunsch, Verlangen, Hoffnung, (2) Erwartung, Aussicht, (3) Optativ, Desiderativ, hoffen, wünschen, erwarten, die Hoffnung auf etw. setzen
撃つ (うつ): (1) abfeuern, schießen, (2) erschießen, totschießen, (3) erlegen, angreifen, bekämpfen, erobern
決心 (けっしん): Entschluss, Entschließung, Beschluss, Entscheidung, sich entschließen, einen Entschluss fassen, zum Entschluss kommen
有らゆる (あらゆる): alles Mögliche, alle, jede, allerhand, allerlei, jegliche
地平線 (ちへいせん): Horizontlinie, Horizont (über dem Land)
丘 (おか): Hügel, Anhöhe, Erhebung, Seite, Platz neben einem, Oka
態と (わざと): absichtlich, mit Absicht, vorsätzlich, geflissentlich, wissentlich
借金 (しゃっきん): (1) Schulden, Geldschulden, (2) ausgeliehenes Geld, Schulden machen, sich verschulden
戦う (たたかう): (1) kämpfen, Krieg führen, fechten, streiten, (2) bekämpfen, widerstehen, (3) wetteifern, spielen
雇う (やとう): (1) anstellen, einstellen, (2) mieten, chartern (ein Fahrzeug), (3) benutzen, ausleihen und benutzen
金銭 (きんせん): (1) Geld, Bargeld, Finanzmittel, (2) Kinsen, eine Goldmünze (erstmals 760 geprägt)
震える (ふるえる): zittern, beben, schaudern, frösteln, sich schütteln
自殺 (じさつ): Selbstmord, Selbsttötung, Freitod, Suizid, Selbstmord begehen, Suizid begehen, sich das Leben nehmen
見舞い (みまい): (1) Besuch, um sein Mitgefühl oder seine Genesungswünsche auszudrücken (bei jmdm., der von einem Unglück oder einer Krankheit betroffen ist), Beileidsbesuch, Krankenbesuch, (2) Beileidsbrief, Beileidsgeschenk, (3) Krankengeschenk, Brief mit Genesungswünschen, (4) Besuch, Aufwartung, (5) Rundgang, Patroullie, Besichtigung
幸せ (しあわせ): Glück, Glücklichkeit, Glückseligkeit, Wohl, Wohlergehen, glückliches Schicksal, glücklich, zufrieden, glücklicherweise, zum Glück
学 (がく): Wissenschaft, Gelehrsamkeit, Bildung, Wissen, Kenntnisse, Lernen, Studium
刀 (かたな): (1) (einschneidiges)Schwert, Langschwert, Katana, (2) Dolch, Degen
税金 (ぜいきん): Steuer, Steuern
重要 (じゅうよう): Wichtigkeit, Bedeutsamkeit, Belang, Wichtigkeit, Bedeutsamkeit, wichtig, bedeutsam, bedeutend, maßgebend, wesentlich
時期 (じき): Zeit, Periode, Jahreszeit, Saison
アイロン: Bügeleisen
整理 (せいり): (1) Anordnung, Einordnung, Ordnung, Regelung, Regulierung, Sanierung, Wiederherstellung, Abbau, (2) Loswerden, Sortieren, (3) Abbezahlen, in Ordnung bringen, ordnen, aufräumen, anordnen, einordnen, regeln, regulieren, sanieren, wiederherstellen, abbauen, konsolidieren
働き (はたらき): (1) Arbeit, Tätigkeit, (2) Funktion, Wirkung, (3) Fähigkeit, Talent, (4) Verdienst
出身 (しゅっしん): (1) Herkunft, Abstammung, (2) Absolvierung einer Uni
優勝 (ゆうしょう): Sieg, Meisterschaft, siegen, eine Meisterschaft erringen
単語 (たんご): Wort, Vokabel, Einzelwort
作業 (さぎょう): Arbeit
女王 (じょおう): Königin
歩道 (ほどう): Gehweg, Fußweg, Bürgersteig, Gehsteig
食品 (しょくひん): Lebensmittel
賛成 (さんせい): Zustimmung, Beipflichtung, Billigung, Einwilligung, Einverständnis, Unterstützung, Beifall, zustimmen, beipflichten, billigen, bewilligen, einwilligen, unterstützen
答案 (とうあん): Prüfungsarbeit, Examensarbeit
美人 (びじん): Schönheit, Schöne, schönes Mädchen, schöne Frau
保証 (ほしょう): Garantie, Bürgschaft, Sicherheit, Zusicherung, garantieren, bürgen, Sicherheit, Garantie, Gewähr, Gewährleistung, versichern, garantieren, gewährleisten, sicherstellen, sichern, zertifizieren
親戚 (しんせき): (1) Verwandter, (2) Verwandtschaft
末 (すえ): (1) Ende, Schluss, Abschluss, (2) Zukunft, Aussicht, (3) Nachkommen, (4) Nebensächlichkeit, Geringfügigkeit, (5) nach
提案 (ていあん): Vorschlag, Antrag, Vorlage, vorschlagen, einen Vorschlag machen, einen Vorschlag einbringen
不正 (ふせい): Unrichtigkeit, Ungerechtigkeit, Unrecht, Unbilligkeit, Unredlichkeit, Ungehörigkeit, Unschicklichkeit, ungerecht, unrecht, unbillig, falsch, schlecht, unangemessen, ungebührlich, unredlich, unrechtmäßig
試す (ためす): versuchen, probieren, prüfen, einen Versuch machen
学問 (がくもん): (1) Wissenschaft, Gelehrsamkeit, Belesenheit, (2) Lernen, Studium, (3) angelerntes Wissen, Kenntnisse, wissenschaftlich arbeiten, studieren, Wissenschaft treiben, sich wissenschaftlich betätigen, Wissenschaftler werden, sich einer Wissenschaft widmen
度 (たび): (1) jedes Mal, immer wenn …, (2) Mal, (3) dieses Mal
論文 (ろんぶん): Abhandlung, Aufsatz, Artikel, Dissertation, Magisterarbeit, Essay, (mn) Traktat, Arbeit
一家 (いっか): (1) ein Haushalt, ein Haus, (2) eine Familie, die ganze Familie, (3) Klan, Großfamilie, (4) Schule (einer Lehre oder Kunst), (5) Autorität, Kapazität, Meister, (6) Einhäusigkeit, Monözie, (1) ein Haushalt, ein Haus, (2) dieselbe Familie, eine Familie, (3) das ganze Haus
ボーイ: (1) Junge, (2) Kellner, Ober, Steward, Page, Hotelboy
流れ (ながれ): (1) Strom, Fluss, Strömung, Bach, Wasserlauf, (2) Abstammung, Abkunft, Deszendenz, Abkömmling, (3) Schule, (4) Strom, Lauf, Ablauf, Verlauf
石炭 (せきたん): Steinkohle, Kohle
会合 (かいごう): Zusammenkunft, Versammlung, Begegnung, Treffen, Party, sich versammeln, zusammenkommen, zusammentreten, eine Versammlung abhalten
独特 (どくとく): eigenartig, eigentümlich, besonders, charakteristisch, eigen, originell, individuell, in einzigartiger Weise, in eigenartiger Weise, eigenartig, eigentümlich, besonders, charakteristisch, eigen, originell, individuell
合図 (あいず): Signal, Zeichen, Wink, ein Zeichen geben, Signal geben, winken
寄付 (きふ): Spende, Beitrag, Stiftung (bes. an öffentliche Organisationen, Tempel und Schreine), Beitrag leisten, beitragen, spenden, beisteuern, stiften
小包 (こづつみ): Paket, Päckchen
態度 (たいど): Einstellung, Haltung, Verhalten, Benehmen, Auftreten
健康 (けんこう): (1) Gesundheit, Wohlbefinden, Fitness, (2) Befinden, gesund, wohl, wohlauf, frisch munter, rüstig
化粧 (けしょう): Schminken, Auftragen von Schminke, Auftragen von Make-up, (1) Schminken, Auftragen von Schminke, Auftragen von Make-up, (2) oberflächliches Verzieren, (3) oberflächlicher Schmuck, (4) Außenfläche, von außen sichtbare Fläche eines Gebäudes, (5) (als Präfix) Schmuck…, Verzierungs…, sich schminken, Make-up auflegen
中学 (ちゅうがく): Mittelschule
貯金 (ちょきん): (1) Sparen, (2) Spargeld, Ersparnisse, (3) Einlage bei Post oder Genosenschaft, (4) bei Post oder Genossenschaft eingelegtes Geld, sparen,  (Geld) einlegen,  (Geld) einzahlen
従う (したがう): (1) folgen, gehorchen, jmdm. Folge leisten, jmdm. nachgeben, sich unterwerfen, (2) annehmen, bewilligen, nach kommen, (3) folgen, sich fügen, sich finden in, sich schicken, sich richten nach, (4) jmdn. begleiten, jmdm. folgen, jmdm. das Geleit geben, (5) willfahren, beistimmen, einwilligen, nachkommen, (6) sich beugen (einer Bestimmung), befolgen (eine Regel)
殺す (ころす): (1) töten, morden, ermorden, umbringen, ums Leben bringen, erschlagen, (2) unterdrücken, anhalten
最高 (さいこう): (1) Maximum, höchste, oberste, beste, (2) Höchst…, Spitzen…., höchster, oberster, bester, maximaler
ハンサム: (1) gutes Aussehen (eines Mannes), (2) gut aussehend, hübsch, gut aussehend, hübsch
得意 (とくい): (1) (2) , (1) geschickt, gut, stark, (2) stolz
大した (たいした): (1) groß, bedeutend, wichtig, beträchtlich, ernst, (2) toll, schrecklich, fürchterlich
年寄り (としより): (1) alter Mensch, alte Leute, Senior, alter Mann, alte Frau, Greis, Greisin, (2) Manager (eines Sumō-Stalles), (3) wichtiger Lehnsherr (des Shōgunats oder eines Damyō), (4) Dorfvorstand (Edo-Zeit), (5) Hauptkammerzofe der Frau des Shōgun (Edo-Zeit)
資源 (しげん): (1) Rohstoff, Bodenschätze, Ressourcen, (2) Hilfsmittel, Material
通過 (つうか): (1) Durchgang, Durchfahrt, Durchreise, (2) Durchzug, (3) Passieren, Passage, Bestehen, durchfahren, passieren
従兄弟 (いとこ): Cousin, Vetter
至る (いたる): (1) ankommen, anlangen, gelangen, erreichen, (2) kommen, gelangen, sich erstrecken, (3) werden, (4) erfolgen, führen (zu etw.)
ぴったり: (1) plötzlich, (2) ganz, komplett, (3) richtig, genau, (1) plötzlich vollkommen zu Ende gehend, (2) eng, exakt, fest passend, (1) fest, dicht, (2) genau, (3) ganz, komplett, perfekt
天候 (てんこう): Wetter
信じる (しんじる): (1) glauben, Glauben schenken, für richtig halten, sicher sein, (2) glauben (Religion), (3) vertrauen, Vertrauen schenken, Vertrauen haben
恋人 (こいびと): Geliebter, Liebhaber, Verliebter, Freund, Freundin
計算 (けいさん): (1) Zählen, (2) Veranschlagung, Schätzung, Überschlag, (3) Rechnung, Berechnung, Rechnen, Berücksichtigung, (1) rechen, berechnen, ausrechnen, zählen, (2) summieren, zusammenrechnen, abschätzen, veranschlagen
お喋り (おしゃべり): (1) Geschwätz, Geplauder, Gerede, Klatsch, Geplapper, (2) Schwätzer, Plauderer, Klatschbase, plaudern, schwatzen, einen Schwatz halten, tratschen
梅 (うめ): Ume, (1) Pflaumenbaum, Pflaume, (2) Pflaumenblüte
正式 (せいしき): Förmlichkeit, Formalität, Regelmäßigkeit, Regularität, Vorschriftsmäßigkeit, vorgeschriebene Form, förmlich, formell, regelmäßig, regelrecht, regulär, vorschriftsmäßig, in förmlicher Weise, in regelrechter Form, vorschriftsmäßig, förmlich, formell, regelmäßig, regelrecht, regulär, vorschriftsmäßig
転ぶ (ころぶ): (1) hinfallen, fallen, stolpern, stürzen, zu Fall kommen, (2) rollen, sich wälzen, sich herumwerfen
頬 (ほお): Backe, Wange, Wange, Backe
舞台 (ぶたい): (1) Bühne, (2) Schauplatz
違い (ちがい): Unterschied, Verschiedenheit, Abweichung, Differenz, Widerspruch, Ungleichheit
アルバム: Album, Fotoalbum, Schallplattenalbum
最終 (さいしゅう): Ende, Schluss, Schluss…, End…, letzter, letzter, finaler
笛 (ふえ): Flöte, Pfeife
好む (このむ): (1) vorziehen, bevorzugen, lieber mögen, (2) gern haben, lieb haben, lieben, schätzen, Geschmack haben an …, mögen, (3) benötigen (z.B. eine Pflanze einen sonnigen Standort), (4) wünschen, verlangen, begehren, fordern
所謂 (いわゆる): sogenannt, angeblich, wie man zu sagen pflegt
配達 (はいたつ): Lieferung, Ablieferung, Zustellung, verteilen, austragen, abliefern
章 (しょう): (1) Kapitel, Abschnitt, (2) Abzeichen, Emblem
需要 (じゅよう): Nachfrage, Bedarf, Kaufwunsch
筆 (ふで): (1) Pinsel, (2) Handschrift, Schrift
少々 (しょうしょう): ein wenig, etwas, ein bisschen
偖 (さて): (1) nun, nun aber, also, so, gut, wohlan, und, (2) in der Zwischenzeit
女子 (じょし): Mädel, Mädchen, (1) Mädchen, Frau, (2) weiblich, weiblich, Frauen…, Mädchen…
現場 (げんば): (1) Ort des Geschehens, (2) Tatort, Ort des Verbrechens, (3) Unfallort, Unfallstelle, (4) Ort der Ausführung (einer Arbeit), Ort der Ausübung (einer Tätigkeit), Einsatzort, (5) Baustelle, (6) tatsächliche Anwendung, Praxis, (7) an Ort und Stelle
投票 (とうひょう): Abstimmung, Wahl, Wahlgang, Stimmabgabe, abstimmen, wählen, seine Stimme geben, sein Votum geben, stimmen
死亡 (しぼう): Tod, Sterben, Umkommen, sterben, umkommen
言わば (いわば): sozusagen, mit einem Wort, um es kurz zu sagen, gewissermaßen
ピクニック: Picknick
感覚 (かんかく): (1) Sinneswahrnehmung, Sinn, (2) Empfindung, Gefühl
書類 (しょるい): Papiere, Akte, Dokument, Schriftstück
現状 (げんじょう): gegenwärtiger Zustand, heutige Situation, jetzige Lage, wie die Dinge stehen, Status quo
ざっと: (1) ungefähr, grob, annähernd, etwa, schätzungsweise, zirka, (2) flüchtig, kursorisch, (3) leichthin, eilfertig
加える (くわえる): (1) addieren, hinzufügen, zusammenzählen, (2) erhöhen, zunehmen, vergrößern, (3) zählen zu, anwenden
少年 (しょうねん): (1) Junge, Knabe, Bube, (2) (mf) Jugendliche, Jugend, (3) Jugendzeit
表す (あらわす): (1) zeigen (z.B. Gefühle), zur Schau stellen, zum Ausdruck bringen, entfalten, (2) enthüllen, entlarven, offenbaren, verraten, ans Licht bringen, (3) bekannt geben, schreiben, herausgeben, veröffentlichen,  (sich) ausdrücken
要求 (ようきゅう): (1) Forderung, Anspruch, Bedürfnis, Verlangen, Erfordernis, Anforderung, (2) Anfrage, Request, (1) fordern, verlangen, (2) erfordern
グラス: Glas, Trinkglas, Gras, Rasen, Günter Grass (dtsch. Schriftsteller und Grafiker; 1927–)
激しい (はげしい): (1) heftig, groß, stark, scharf, ungestüm, rasend, furchtbar, tief, hart, intensiv, streng, (2) feurig, glühend, heiß, bitter, laut, herzhaft, leidenschaftlich, passioniert, (3) umfangreich, umfassend, umwälzend, (4) steil, schroff
合格 (ごうかく): erfolgreiches Ablegen (einer Prüfung), Bestehen, bestehen
団体 (だんたい): Gruppe, Mannschaft, Organisation, Kollektiv
恐らく (おそらく): wahrscheinlich, vermutlich, möglicherweise, vielleicht
仏 (ほとけ): (1) Erleuchteter, Buddha, (2) Shakyamuni, Shakyamuni Buddha, (3) buddhistischer Heiliger, sehr tugendhafter Mönch, (4) Buddhadarstellung, Buddhastatutue, (5) der geschriebene Name Buddhas, (6) buddhistische Lehre, Buddhismus, (7) Buddhist, (8) Toter, Verstorbener, Verblichener, (9) Leiche, Leichnam, (10) Seele eines Verstorbenen, (11) naive gutmütige Person
頼る (たよる): (1) sich verlassen auf, sich stützen auf, abhängen, (2) bauen auf, zu etw. greifen
数 (すう): (1) Nummer, Zahl, (2) Schicksal, Bestimmung, (3) Gesetz
科目 (かもく): (1) Schulfach, Fach, Fachgebiet, (2) Gegenstand, (1) Listenpunkt, (2) Lehrplan, Curriculum, Lehrfach, Unterrichtsfächer
善 (ぜん): Gutes, Güte, gute Tat
旧 (きゅう): (1) (2) 
神 (かみ): Gott, Göttin, Gottheit, Kami, der Allmächtige
劇場 (げきじょう): (1) Theater, Schauspielhaus, (2) Kino, Filmtheater, Lichtspielhaus
教師 (きょうし): (1) Lehrer, Lehrerin, Dozent, Studienrat, Pädagoge, (2) religiöser Lehrer, religiöser Führer
年代 (ねんだい): (1) Regierungsperiode, (2) Epoche, Periode, Zeitalter, Generation, (3) Jahrzehnt, …er Jahre, (4) Jahr
費用 (ひよう): Unkosten, Kosten, Ausgaben, Aufwand
横切る (よこぎる): überqueren, kreuzen (z.B. einen Weg, den Bahnübergang etc.)
公平 (こうへい): (1) Unparteilichkeit, Fairness, (2) Gerechtigkeit, Ehrlichkeit, Billigkeit, (3) Uneigennützlichkeit, Selbstlosigkeit, fair, unparteiisch, gerecht, objektiv, unparteiisch, fair, gerecht
中止 (ちゅうし): Aufhebung, Aufhören, Einstellung, Suspendierung, Unterbrechung, abbrechen, absage, aufgeben, ausfallen lassen
迎え (むかえ): (1) Abholen, Entgegengehen, Willkommenheißen (auch die Seelen der Verstorbenen am O-Bon-Fest), (2) Abholer, (3) jmd., der einen anderen erwartet
愛情 (あいじょう): (1) Liebe, Zuneigung, Herzlichkeit, (2) geschlechtliche Liebe, Liebe zum anderen Geschlecht
注 (ちゅう): Notiz, Anmerkung
動詞 (どうし): Verb, Verbum, Zeitwort, Tätigkeitswort
立ち上がる (たちあがる): (1) aufstehen, sich erheben, (2) aufbegehren, sich gegen etw. erheben, (3) sich erholen, wieder gesund werden, (4) booten, starten
観察 (かんさつ): Beobachtung, Beaufsichtigung, Überwachung, beobachten, betrachten
記者 (きしゃ): Journalist, Reporter, Zeitungsjournalist, Zeitschriftenjournalist, Korrespondent
対 (つい): Paar
事態 (じたい): Sachlage, Sachverhalt, Stand der Dinge, Situation, Tatbestand, Umstand, Verhältnisse
バッグ: Tasche, Bug, Programmierfehler
エンジン: Motor
重視 (じゅうし): Wichtigkeit, Bedeutung, ernst nehmen, für wichtig halten, große Bedeutung beimessen, Wert legen auf
だけど: aber, allein, dennoch, obgleich, doch
登山 (とざん): Bergsteigen, Bergaufstieg, auf einen Berg gehen, einen Berg besteigen
爆発 (ばくはつ): (1) Explosion, Detonation, Bersten, Platzen, Entladung, Verpuffung, (2) Ausbruch, (1) explodieren, detonieren, verpuffen, (2) ausbrechen
真逆 (まさか): (1) Mensch!, (2) Mein Güte!, (3) Auf keinen Fall!, (4) Das kann nicht wahr sein!, (5) Ausgeschlossen!
セット: (1) Satz, Garnitur, Service, (2) Satz, (3) Gerät, Apparat, Anlage, Set, (4) Bühnenausstattung, Bühnenbild, (5) Dekorationsbauten, (6) Frisieren, (7) Festsetzen von etw
出来事 (できごと): Ereignis, Vorfall, Vorkommnis, Begebenheit, Zwischenfall, Zufall, Unfall
略 (ほぼ): ungefähr, etwa, fast, beinahe
きちんと: (1) richtig, genau, korrekt, akkurat, exakt, (2) pünktlich, fristgemäß, (3) unverzüglich, ohne Verzug, (4) wie verabredet, (5) regelmäßig, (6) ordentlich, anständig, tadellos, sorgfältig, sauber, adrett, in Ordnung bringen, richtig stellen, aufräumen
誕生 (たんじょう): (1) Geburt, (2) Entstehung, Gründung, Herstellung, (1) geboren werden, zur Welt kommen, ins Leben gerufen werden, das Licht der Welt erblicken, (2) entstehen, errichtet werden, gegründet werden, eingerichtet werden, neu hergestellt werden
暮らす (くらす): (1) leben, sich erhalten, sich ernähren, seinen Lebensunterhalt verdienen, sein Brot verdienen, auskommen, (2) zubringen, hinbringen
けち: Unglück, Unglückszeichen, Dämpfer, (1) geizig, (2) arm, winzig, beschränkt
恐れる (おそれる): (1) Angst haben, sich fürchten, sich scheuen, verängstigt sein, angsterfüllt sein, (2) befürchten, sich sorgen, (3) Ehrfurcht haben, fürchten, (4) sprachlos sein, verblüfft sein, verlegen sein
換える (かえる): (1) wechseln, auswechseln, tauschen, austauschen, umtauschen, vertauschen, einsetzen für, austauschen gegen, (2) ersetzen, an die Stelle setzen, einsetzen, die Stelle einnehmen, (3) um eine weitere Portion Essen bitten, um einen Nachschlag bitten, Essen nachfassen
絶対 (ぜったい): (1) (2) , absolut
命じる (めいじる): (1) befehlen, anordnen, einen Befehl erteilen, anweisen, (2) ernennen, berufen
普段 (ふだん): gewöhnlich, normal, alltäglich
覚悟 (かくご): (1) Bereitschaft, Gefasstheit, Entschlossenheit, Entschluss, Einsicht, (2) Erlangen der Erleuchtung, (3) Wissen, (4) Lernen, (5) Verzicht, Resignation, Entsagung, sich auf etw. gefasst machen, sich entschließen, sich bereit machen, seine Hoffnungen aufgeben
技師 (ぎし): Ingenieur, Techniker
例え (たとえ): (1) Gleichnis, Allegorie, Vergleich, Beispiel, Metapher, Sinnbild, (2) Fabel, Parabel, Sprichwort
強力 (きょうりょく): Stärke, Kraft, Macht, Effekt, kräftig, kraftvoll, mächtig, machtvoll, stark
雰囲気 (ふんいき): Atmosphäre, Stimmung, Flair
具体 (ぐたい): Konkretheit, Gegenständlichkeit, Materialität
救助 (きゅうじょ): Rettung (einer Person in Not oder Gefahr), Bergung, Befreiung, Hilfe, Unterstützung, retten, erretten, bergen, befreien, helfen
中古 (ちゅうこ): (1) Mittelalter (in Japan die Heian-Zeit), (2) alt, gebraucht, aus zweiter Hand, Gebraucht…, Gebrauchtwaren, Gebrauchtsein, (1) mittelalterlich, (2) alt, gebraucht, aus zweiter Hand, antiquarisch, alt, gebraucht, aus zweiter Hand, antiquarisch
嫁 (よめ): (1) Schwiegertochter, (2) frischverheiratete Frau, (3) Braut
図書 (としょ): (1) Bücher, (2) Karten und Schriften
基本 (きほん): Fundament, Grundlage, Grund, Basis
郵便 (ゆうびん): Zeichen für Post und Postleitzahl, Post, Postbeförderung
偶然 (ぐうぜん): (1) (2) , zufälligerweise, durch Zufall, zufällig
論争 (ろんそう): Auseinandersetzung, Disput, Disputation, Wortgefecht, Wortstreit, disputieren, sich streiten, einen Wortstreit führen
直 (じき): (1) sofort, gleich, bald, (2) Direktheit, direkt
其れ共 (それとも): oder, oder aber
手術 (しゅじゅつ): Operation, chirurgischer Eingriff, operieren
通じる (つうじる): (1) sich auskennen, Bescheid wissen, (2) verstanden werden, sich verständigen können, erhört werden, (3) führen, gehen nach, eröffnet werden, (4) heimlich in Verbindung treten, sich heimlich in Verbindung setzen, in Verbindung stehen mit, (5) einen Telefonanschluss bekommen, eine Verbindung bekommen, (6) den Strom einschalten
除く (のぞく): (1) aussortieren, aussondern, (2) ausschließen, beseitigen, (3) absehen von, auslassen
限る (かぎる): (1) sich beschränken, begrenzen, abgrenzen, einschränken, Grenzen ziehen, (2) nichts geht darüber, über alles gehen, am besten sein, (3) (in der Wendung „… wa … ni kagiru“) bei … ist … das Beste
金 (かね): (1) Metall, (2) Geld, Bargeld, (3) Münze, Vermögen, Mittel, Betrag
応じる (おうじる): (1) antworten, erwidern, (2) annehmen, akzeptieren, (3) entsprechen, (4) sich bewerben
気の毒 (きのどく): (1) Bedauern, Mitleid (mit einer anderen Person), (2) Bedauern (für eine Störung), (3) Herzensschmerzen, Ratlosigkeit, bedauernswert, bejammernswert, bemitleidenswert, bedauerlich, mitleiderregend, erbärmlich, arm
叩く (たたく): (1) schlagen, hauen, (2) klopfen, pochen, (3) heruntermachen (z.B. in der Zeitung), (1) abstauben, ausklopfen, (2) klopfen, schlagen, (3) ohrfeigen, einen Klaps geben, jmdm. eine langen, (4) ausleeren
実施 (じっし): Ausführung, Durchführung, Durchsetzung, Verrichtung, Vollziehung, Inkraftsetzung, ausführen, durchführen, in Kraft setzen, verrichten, vollziehen
さっぱり: einfach, rundweg, überhaupt nicht, durchaus nicht, nicht im Geringsten, nicht im Mindesten, alles andere als, nicht im Entferntesten, sich erfrischt fühlen, sich erleichtert fühlen, sich erquickt fühlen
夜中 (よなか): Mitternacht, mitten in der Nacht
立場 (たちば): (1) Platz zum Stehen, Stand, Standpunkt, Standort, Stelle, (2) Standpunkt, Gesichtspunkt, Position, Lage
物質 (ぶっしつ): Stoff, Substanz, Materie, Material, Materielles
芸術 (げいじゅつ): (1) Kunst, schöne Künste, (2) Technik, (3) Kunst und Wissenschaft
王子 (おうじ): (1) (königlicher od. kaiserlicher)Prinz, (2) nicht als Prinz proklamierter Sohn des Kaisers, (3) Ōji-Perücke (für Schurken und Verräter aus dem Hofadel)
宝石 (ほうせき): Edelstein, Juwel
無視 (むし): Missachtung, Ignorierung, unbeachtet lassen, ignorieren, missachten, außer Acht lassen, keine Notiz nehmen von …, übergehen, übersehen
毒 (どく): (1) Gift, (2) Schaden, (3) Bosheit, Boshaftigkeit
独身 (どくしん): Junggesellenstand, Ledigkeit, Ehelosigkeit, (mn) Zölibat, unverheiratet, ledig
資本 (しほん): (1) Kapital, Geldmittel, Fonds, (2) Vermögen, Besitz
指す (さす): (1) zeigen auf …, hinweisen auf …, hindeuten auf …, (2) Shōgi spielen, (3) aufrufen
正に (まさに): gerade, als …, wirklich, (1) richtig, genau, (2) gerade, pünktlich, eben
以前 (いぜん): (1) vor, bevor, vorher, (2) bis zu diesem Niveau, (3) früher, einst, ehemals, ehedem, vormals, einmal
解く (とく): (1) auflösen, aufknoten, aufschnüren, aufmachen, auftrennen (einen Knoten etc.), (2) entlassen (aus einer Pflicht), befreien (von Fesseln), (3) auflösen (in einer Flüssigkeit), lösen, schmelzen, (4) lösen, beantworten, aufklären
余裕 (よゆう): (1) freie Zeit, (2) Spielraum, Spiel, Überfluss, (3) freie Ressourcen an Raum, Zeit, Kraft od. Geld, (4) innere Ruhe, Gelassenheit
望み (のぞみ): (1) Wunsch, Sehnsucht, (2) Hoffnung, Erwartung, Streben
秒 (びょう): Sekunde
集団 (しゅうだん): Gruppierung, Gruppe, Masse
克服 (こくふく): Überwindung, überwinden, besiegen, verwinden
プロ: (1) Profi, Professionell, (2) Produktion, Herstellung, Studio, Produzent, Produktionsfirma, (3) Propaganda, (4) Programm, (5) Proletarier, (6) Prozent, professionell
違反 (いはん): Verstoß (gegen Gesetze, Regeln, Abkommen, Verträge etc.), Vergehen, Übertretung, Verletzung, Gesetzesübertretung, sich vergehen, ein Vergehen begehen, übertreten, verletzen, verstoßen
学習 (がくしゅう): (1) Lernen, Studium, (2) Lernen, (3) Lernen, (4) Lernen, lernen, studieren
凡そ (およそ): (1) ungefähr, etwa, zirka, annähernd, gegen, (2) ganz, überhaupt, (3) ziemlich
減る (へる): (1) abnehmen, sich vermindern, sich verringern, (2) zurückschrecken, erschrecken, sich fürchten, zurückweichen
元 (もと): (1) Zutate, Rohstoff, (2) Kapitalbetrag, (1) Anfang, Beginn, Ursprung, (2) Grundlage, Wurzel, Herkunft, Quelle, (3) Ursache, Anlass, Grundlage, Grund, (4) Material, Rohstoff, Ausgangsmaterial, (5) Kapital, Geldanlage, Kosten, Selbstkostenpreis, (6) Stamm, Stängel, Stiel, (7) Oberstrophe eines Waka
才能 (さいのう): Intelligenz und Können, Talent, intellektuelle Begabung, Fähigkeit
豊か (ゆたか): reich, reichlich, ergiebig, genügend, üppig, viel, in Hülle und Fülle, in Mengen, bemittelt, vermögend, wohlhabend, Reichtum, innerer Reichtum, reich, reichlich, ergiebig, wohlhabend, reichlich, in Hülle und Fülle, in Mengen, im Überfluss
乗客 (じょうきゃく): Passagier, Fahrgast
無駄 (むだ): Vergeblichkeit, Leerlauf, Nutzlosigkeit, Fruchtlosigkeit, Verschwendung, Vergeudung, (1) vergeblich, nutzlos, fruchtlos, fruchtlos, unnütz, (2) verschwenderisch, (1) umsonst, vergebens, vergeblich, unnötig, unnütz, (2) verschwenderisch
節 (ふし): (1) Bambusknoten, Astknoten, Knoten, (2) Gelenk, Knöchel, (3) Melodie, Noten, Ton, Stimmung, Intonation, (4) Punkt, Stelle
切れ (きれ): (1) Tuch, Stoff, (2) Schärfe eines Messers, Schneide, (3) Stück, Stückchen, Bissen, Happen, Scheibe, (4) Schnitt, Schnitzel, Splitter
年齢 (ねんれい): Jahr, Alter
全体 (ぜんたい): Gesamtheit, Ganzes, Totalität
考慮 (こうりょ): Überlegung, Erwägung, Nachdenken, in Betracht ziehen, überlegen, erwägen, nachdenken, in Erwägung ziehen
ロケット: Rakete, Medaillon
苦しい (くるしい): (1) (körperlich) schmerzhaft, schmerzvoll, schmerzend, qualvoll, peinigend, leidvoll, (2) (seelisch) schmerzhaft, schwer, hart, mühsam, mühselig, schwierig, verwirrt, (3) arm, bedürftig, notleidend, (4) an den Haaren herbeigezogen (z.B. eine Erklärung, Ausrede etc.), gezwungen, unnatürlich, gewaltsam, (5) (an Renyō・kei von Verben) schwierig zu …, unangenehm zu …, (6) schwierig, problematisch, (7) unbequem, unangenehm, lästig
通り過ぎる (とおりすぎる): passieren, vorbeigehen, vorübergehen, vorbeifahren, vorüberfahren, überfahren, durchgehen, durchfahren
見事 (みごと): (1) wunderbar, schön, prächtig, herrlich, ausgezeichnet, wunderschön, prima, (2) ziemlich, gewaltig, völlig, total, in wunderbarer Weise, herrlich, wunderbar, wunderschön, erfolgreich
分 (ぶ): (1) Vorteil, (2) Dicke (von flachen Dingen), (3) ein Prozent, ein Hunderstel, (4) ein Zehntel, (5) ein Viertel (einer Note), (6) ein Zehntel Grad (°C; der Körpertemperatur), (7) Bu, Fun (Währungseinheit; ein Viertel Ryō, ein Zehntel Mon; in der Edo-Zeit), (8) Bu (Längenmaß im Shaku-Kan-System; ein Hundertstel Shaku, ein Zehntel Sun), (9) Bu (Gewichtsmaß im Shaku-Kan-System; ein Zehntel Monme), (10) Bu (Schuhmaß; ein Zehntel Mon)
疑問 (ぎもん): (1) Frage, Problem, (2) Zweifel, Verdacht
閉じる (とじる): schließen, abschließen, zuschließen (z.B. auch in EDV: ein Fenster der Computer-Benutzeroberfläche)
汚染 (おせん): Verschmutzung, Verunreinigung, Verseuchung, Verpestung, Kontamination, verschmutzen, verunreinigen, verpesten, verseuchen
印刷 (いんさつ): (1) Drucken, (2) Druck, (3) Ausdrucken, (4) Ausdruck, (1) drucken, drucken lassen, zum Druck geben, (2) ausdrucken
回復 (かいふく): (1) Wiederherstellung, Genesung, Besserung, Heilung, (2) Restitution, Restauration, Wiederaufleben, (3) Rehabilitation, Rehabilitierung, wiedererlangen, wiederbekommen, in den früheren Zustand zurückversetzen, sich rehabilitieren, wieder gesund werden, das Vertrauen wiedergewinnen, Genesung, Gesundung, Erholung
日中 (にっちゅう): (1) Tageszeit, (2) am hellen Tag, (3) am Mittag, tagsüber, Japan und China, Sinojapanisch, Tageszeit, helllichter Tag
審判 (しんぱん): (1) Entscheidung, Urteil, (2) Schiedsrichter, (1) entscheiden, urteilen, (2) als Schiedsrichter fungieren
と: (1) und, sowie, oder, (2) mit, zusammen mit, gemeinsam mit, (3) gegen, (4) wenn, falls, als, (5) auch wenn, (6) immer wenn
パイロット: (1) Pilot, Flugzeugführer, (2) Lotse, (3) Kontrolllampe (Abk.)
嵐 (あらし): (1) Sturm, Sturmwind, Unwetter, Gewitter, (2) Sturm der Entrüstung, Aufruhr, Arashi
質 (しつ): (1) Qualität, (2) Natur, Eigenart, (3) Substanz, Material, Stoff
罰する (ばっする): bestrafen, strafen
到着 (とうちゃく): Ankunft, Eintreffen, ankommen, eintreffen
咳 (せき): (1) Husten, Husten, (2) Räuspern, Hüsteln, Husten, Tussis
居眠り (いねむり): (1) Einnicken (im Sitzen), Schläfchen (im Sitzen), (2) Einschlafen, während man etwas tut, einnicken, ein Schläfchen machen
人工 (じんこう): Künstlichkeit, Menschenwerk, künstlich, menschengemacht
句 (く): (1) Unterbrechung in einem Satz, Einschnitt in einem Wort, (2) Phrase, Nebensatz, Satz, (3) Vers, Zeile, (4) Strophe, (5) rhythmische Einheit eines Gedichtes, (6) Haiku, Hokku, Gedicht, (7) Zählwort für Strophen bzw. für Haiku und Senryū
面倒 (めんどう): (1) Umstände, Unannehmlichkeit, Mühe, Last, Schwierigkeit, Schererei, (2) Betreuung, mühsam, mühevoll, lästig, schwierig, unangenehm, kompliziert, mühsam, mühevoll, schwierig, umständlich, kompliziert, lästig
パスポート: Reisepass, Pass
適する (てきする): (1) sich eignen, passen, passend sein, tauglich sein, entsprechen, gut sein, zusagen, (2) für etw. angepasst sein, (3) ebenbürtig sein, gewachsen sein
議会 (ぎかい): Parlament, Volksvertretung, Kongress, Bundestag, Landtag, Reichstag, Präfekturversammlung, Kommunalversammlung
髪の毛 (かみのけ): Haar, Haare
可哀相 (かわいそう): (1) arm, traurig, bemitleidenswert, zu bedauern, (2) rührend, ergreifend, (3) grausam, unbarmherzig, roh, arm, traurig
案 (あん): (1) Idee, Gedanke, Einfall, (2) Ansicht, Meinung, (3) Plan, Entwurf, Vorschlag, Konzept, Gesetzesvorlage, (4) Vorhersagen, (5) Plan, Vorhaben, Projekt, Vorsatz, (6) (elegant)Tisch, (7) Nachdenken, Vernunft, Verstand, (1) Ruhe, Stille, Frieden, (2) Einfachheit, Leichtigkeit, (3) Günstigkeit des Preises, (4) Ammoniak (Abk.)
直に (じかに): direkt, in direkter Weise, persönlich, mit eigenen Augen
表情 (ひょうじょう): Ausdruck, Gesichtsausdruck, Miene, Äußerung
度々 (たびたび): oft, öfters, häufig, mehrmals, wiederholt
全員 (ぜんいん): alle, alle Beteiligten, die ganze Besatzung, die ganze Mannschaft, sämtliche Mitglieder, das ganze Personal
飽きる (あきる): (1) müde werden, (2) satt haben, einer Sache überdrüssig werden, einer Sache müde sein, das Interesse an etw. verlieren
指導 (しどう): Anleitung, Leitung, Unterweisung, Direktion, Führung, Training, Beratung, führen, leiten, dirigieren
主張 (しゅちょう): (1) Behauptung, Geltendmachung, Beteuerung, (2) Meinung, Ansicht, Standpunkt, (3) Vorbringen, Behauptung, Erklärung, behaupten, geltend machen, beharren, durchsetzen
人種 (じんしゅ):  (menschliche)Rasse, Menschenrasse
どんなに: (1) wie, wie sehr, in welchem Ausmaß, (2) wie sehr auch, egal wie, (3) irgendwie
絵画 (かいが): Malerei, Gemälde, Bild, Zeichnung, Skizze, Bildnis
回す (まわす): (1) drehen, kreisen lassen, kreisen lassen, (2) herumgehen lassen, herumreichen, (3) weitergeben, weitersenden, weiterschicken, (4) übersenden, übermitteln, schicken, (5) ersetzen, ergänzen, (6) versetzen, (7) (Geld) verleihen
話題 (わだい): Gesprächsstoff, Gesprächsgegenstand, Gesprächsthema, Thema der Unterhaltung
煙 (けむり): Rauch, Qualm (Abk.), (1) Rauch, Qualm, (2) Dunst, Nebel, (3) Rauchfahne des Küchenfeuers, Küchenrauch, (4) Lebensunterhalt
あんなに: so, so sehr, in solch einer Weise
方法 (ほうほう): Methode, Art und Weise, Weg, Verfahren, Mittel, Schritt, Maßnahme
柄 (がら): (1) Muster, Design, (2) Körperbau, Figur, Gestalt, (3) Typus, Charakter, Natur, Format
説 (せつ): (1) Meinung, Ansicht, (2) Theorie, Lehre, (3) Bestätigung, (4) Gerücht
含む (ふくむ): im Mund behalten, für sich behalten, (1) enthalten, einschließen, umfassen, (2) im Mund behalten, (3) auf dem Herzen haben, beherzigen, im Gedächtnis behalten, (4) implizieren, enthalten
喜び (よろこび): (1) Freude, Vergnügen, (2) glückliches Ereignis, (3) Gratulation
特徴 (とくちょう): Eigentümlichkeit, charakteristisches Merkmal, Charakteristikum, Besonderheit
全て (すべて): (1) alles, jeder, (2) völlig, ganz, gesamt, restlos, vollständig, alle, jeder
金属 (きんぞく): Metall
対象 (たいしょう): (1) Ziel, (2) Gegenstand (auch Philos.), Objekt, Untersuchungsgegenstand
困難 (こんなん): (1) Schwierigkeit, Problem, (2) Mühe, Leid, Mühsal, Not, Verlegenheit, Bedrängnis, schwierig, schwer, mühsam, problematisch, lästig, unangenehm, störend
選択 (せんたく): Auswahl, Auslese, Wahl, Selektion, auswählen
訓 (くん): Kun-Lesung, japanische Lesung eines Kanji
欠点 (けってん): (1) Mangel, Defizit, Schwäche, Makel, Nachteil, (2) Fehler, Misserfolg, (3) Nichterreichen der zum Bestehen notwendigen Punktzahl , geringere Punktzahl, als zum Bestehen notwendig ist
不足 (ふそく): (1) Mangel, Knappheit, (2) Unzufriedenheit, Widerwillen, mangeln an, es fehlt an
屋根 (やね): (1) Hausdach, Gebäudedach, (2) Dach
コーチ: Trainer, Coach, trainieren
骨 (ほね): (1) Knochen, Bein, Gräte, (2) Rippe, (3) Charakterstärke, (4) Anstrengung, Mühe
受け取る (うけとる): (1) empfangen, erhalten, bekommen, annehmen, (2) auffassen, verstehen, interpretieren
休憩 (きゅうけい): Pause, Rast, Ruhepause, rasten, Pause machen
引っ張る (ひっぱる): (1) ziehen, zerren, spannen, abschleppen, schleifen, (2) auffordern, anlocken, einladen, heranziehen, hineinziehen, an sich ziehen, (3) hindehnen, verlängern, hinziehen, aufschieben, (4) abführen, (5) tragen, aufsetzen
刑事 (けいじ): (1) Kriminalsache (im Gegensatz zur Zivilsache), (2) Kriminalbeamter, Kriminalpolizist, Kommissar, Kriminaler
打つ (ぶつ): (1) schlagen, (2) (Rede) halten, (3) (um Geld) spielen
失望 (しつぼう): Enttäuschung, Ernüchterung, Desillusion, enttäuschte Hoffnung, enttäuscht sein, ernüchtert sein, eine Enttäuschung erfahren
住宅 (じゅうたく): Wohnung, Wohnhaus, Häuserblock, Herrenhaus
勇気 (ゆうき): Mut, Courage, Kühnheit, Tapferkeit, Schneid
重大 (じゅうだい): Ernst, Ernsthaftigkeit, Wichtigkeit, wichtig, ernst, bedeutend, schwer
カード: Karte, Kartei, Karteikarte, Zettel
コード: (1) Schnur, (2) Leitung, Akkord, Code
異なる (ことなる): abweichen, sich unterscheiden, anders sein, differieren, nicht gleich sein, nicht übereinstimmen, verschieden sein
気味 (きみ): (1) Gefühl, Empfindung, (2) Anflug von …, eine Spur von …
テント: Zelt
俳優 (はいゆう): Schauspieler, Schauspielerin
自慢 (じまん): (1) Stolz, Hochmut, Dünkel, (2) Eigenlob, Selbstlob, (3) Angeberei, Prahlerei, angeben, aufschneiden
幸い (さいわい): (1) (2) , glücklich, segensreich, glücklicherweise, zum Glück
会計 (かいけい): (1) Bezahlung, (2) Rechnung, (3) Abrechnung, Buchhaltung, Finanzen, Geschäftsbücher, (4) Buchhalter, (5) ökonomische Situation
一時 (いちじ): (1) ein Uhr, (2) eine Weile, (3) zeitweilig, eine Zeit lang, vorübergehend, einstweilen, provisorisch, (4) einst, einmal, zu einer Zeit, einstweilig, provisorisch, vorläufig, zeitweilig
他 (た): ein anderer, etw. anderes, anderer
老い (おい): Alter, Lebensabend
地 (ち): Erde, Boden, Grund, Ort
留学 (りゅうがく): Studium im Ausland, Auslandsstudium, im Ausland studieren
知事 (ちじ): Gouverneur (einer Präfektur), Präfekt
衝突 (しょうとつ): (1) Zusammenstoß, Zusammenprall, Kollision, Anstoß, Anprall, Krach, (2) Konflikt, (3) Gefecht, (1) zusammenstoßen, kollidieren, stoßen (gegen), prallen (gegen), (2) in Konflikt geraten, (3) sich in ein Gefecht verwickeln
妙 (みょう): (1) Klugheit, Geschicklichkeit, Gewandtheit, (2) Wunder, Mysterium, (3) Sonderbarkeit, Seltsamkeit, Merkwürdigkeit, (4) (in der Geheimspr. der Mönche)Frau, Mädchen (weil sich das Zeichen in die Graphemkomponenten von shōjo少女 aufspalten lässt), (5) Hervorragendheit, (1) sonderbar, seltsam, merkwürdig, geheimnisvoll, (2) geschickt, seltsam, merkwürdig, mysteriös, wundersam
急に (きゅうに): (1) dringend, eilig, plötzlich, unerwartet, aus heiterem Himmel, sofort, auf der Stelle, (2) steil, schnell, reißend
利益 (りえき): (1) Gewinn, Ertrag, Profit, Marge, Zinseinkommen, (2) Vorteil, Nutzen, Interesse, heilige Gnade, göttliche Hilfe
狂う (くるう): (1) verrückt werden, irrsinnig werden, wahnsinnig werden, geisteskrank werden, (2) einer Sache od. jmdm. verfallen (einer Frau, der Spielsucht, der Trinkerei etc.), sich einer Sache hingeben, wild nach etw. od jmdm. werden, (3) von etw. bewegt werden, von etw. ergriffen werden (nach anderem Verb), (4) abweichen (von einer Vorhersage), (5) in Unordnung geraten, abweichen, sich verschieben, nachgehen, schief gehen, daneben gehen, fluktuieren, (6) verzaubert werden, verhext werden, (7) sich wie besessen bewegen, (8) spielen, toben, tollen
誤解 (ごかい): Missverständnis, Irrtum, Verwechslung, missverstehen, falsch auffassen, im Irrtum sein, missdeuten, sich irren, sich täuschen
ベンチ: (1) Bank, (2) Ersatzbank (Baseball, Fußball etc.)
現れ (あらわれ): (1) Zeichen, Äußerung, Symptom, Ausdruck, (2) Offenbarung, Erscheinung
衣服 (いふく): (1) Kleidung, Kleider, (2) Kleiden
移動 (いどう): (1) Fortbewegung, Bewegung, Ortsveränderung, Lokomotion, Platzwechsel, Wanderung, (2) Personalwechsel, Fluktuation, den Ort wechseln, sich fortbewegen, etw. bewegen, sich bewegen
何でも (なんでも): (1) alles, was auch immer, (2) es heißt, man sagt, ich habe gehört
ボート: Bolzen, Boot
サービス: (1) Kundendienst, Service, Bedienung, (2) Kulanz, Sonderpreis, Gratis…, (3) Aufschlag, umsonst dazu geben, umsonst machen, servieren, Service leisten, (1) Kundendienst, Service, Bedienung, (2) Kulanz, Sonderpreis, Gratis….
日付 (ひづけ): Datum, Tagesangabe
飛び出す (とびだす): (1) abfliegen, hinauslaufen, weglaufen, (2) vorspringen, (3) ausbrechen
位置 (いち): Standort, Lage, Position, (1) Lage, Stelle, Stellung, Position, Standort, Situation, Platz, (2) Standpunkt, (3) Situs (Lage eines Organs, eines Fetus), sich befinden, positioniert sein
商人 (しょうにん): Händler, Kaufmann, Händler, Ladenbesitzer, Händler, Kaufmann
努力 (どりょく): Anstrengung, Mühe, Bemühung, Bestreben, sich anstrengen, sich bemühen
国民 (こくみん): Nation, Volk, Bürger, Staatsbürger
少女 (しょうじょ): (1) Fräulein, Mädchen, Mädel, Jungfer, (2) unverheiratete Frau, Jungfrau, (3) Tänzerin (die anlässlich des kaiserlichen Erntefestes tanzt), Mädchen, kleines Mädchen
意志 (いし): (1) Wille, Absicht, Vorhaben, (2) Wille, (3) Wille, Wollen, (4) Voluntativ
松 (まつ): (1) Kiefer, Fichte, Föhre, Lärche, Nadelhölzer, Pinus, (2) Neujahrsschmuck, (3) die Zeit, in der man den Neujahrsschmuck aufstellt ., Matsu
集まり (あつまり): (1) Zusammenkunft, Treffen, Versammlung, (2) Ansammlung, Sammlung
地方 (ちほう): (1) Gegend, Gebiet, Region, Distrikt, Kreis, (2) Land, Provinz (im Gegensatz zur Stadt), (3) Landstrich, Gegend, Umgebung, Nähe, (1) lokal, regional, kommunal, (2) ländlich, provinziell
下り (くだり): (1) Abstieg, Absteigen, Neigung, Abhang, Gefälle, Abböschung, (2) Zug, der aus einer Großstadt abfährt (Abk.)
波 (なみ): (1) Welle, Woge, Brandung, Brecher, (2) Flut, (3) Fluktuation, Schwankungen, Wellen, (4) Falten
支える (ささえる): (1) unterstützen, beistehen, ernähren, unterhalten, halten, (2) stützen, tragen, abstützen, absteifen, abfangen, verstreben, (3) verteidigen, behaupten, aushalten, abwehren
気づく (きづく): (1) bemerken, merken, wahrnehmen, Notiz nehmen, herausfinden, achten, (2) zu sich kommen, zur Besinnung kommen, das Bewusstsein wiedererlangen
床 (ゆか): Fußboden, Boden
巣 (す): (1) Nest, Bienenkorb, Wespennest, Horst, Bau, Höhle, Schlupfwinkel, (2) Räubernest, Räuberhöhle
感謝 (かんしゃ): Dankbarkeit, Dank, Dankgefühl, Erkenntlichkeit, Verbundenheit, danken
変化 (へんか): (1) Veränderung, Variation, Wandel, Wandlung, Wechsel, Abwechslung, Umgestaltung, (2) Flexion, Beugung, Konjugation, Deklination, (1) sich verändern, sich verwandeln, Veränderungen durchmachen, sich abwechslungsreich gestalten, variieren, sich umgestalten, (2) flektieren, beugen, deklinieren, konjugieren
食う (くう): (1) (2) 
陸 (りく): Land, Festland, festes Land, Festland, Land, festes Land
広告 (こうこく): (1) Werbung, Reklame, Anzeige, Annonce, Inserat, (2) Bekanntmachung, Verbreitung, (1) Reklame machen für …, werben für …, annoncieren, (2) bekannt machen, verbreiten
優秀 (ゆうしゅう): hervorragende Qualität, hervorragende Leistung, Überlegenheit, hervorragend, ausgezeichnet, vorzüglich, prima
想像 (そうぞう): Einbildung, Fantasie, Annahme, Vorstellung, Vermutung, sich vorstellen, sich denken, annehmen, mutmaßen, vermuten, eingebildet, imaginär, mutmaßlich, vermutlich
思い出 (おもいで): Erinnerung, Andenken, Erinnerungszeichen
諦める (あきらめる): aufgeben (z.B. einen Plan), verzichten, entsagen, hinnehmen, sich abfinden mit …, sich etw. gefallen lassen, sich fügen
穀物 (こくもつ): Getreide, Zerealie
厄介 (やっかい): (1) Last, Mühe, Belästigung, Umständlichkeit, (2) Unterstützung, Hilfe, umständlich, beschwerlich, lästig, belästigend, mühsam
贅沢 (ぜいたく): luxuriös, schwelgerisch, extravagant, kostbar, Luxus, Üppigkeit, Verschwendung, Schwelgerei, Ausschweifung
対 (たい): (1) gegen, wider, (2) gegenüber, (3) im Verhältnis zu …, mit …
反抗 (はんこう): Widerstand, Rebellion, Ungehorsam, Auflehnung, Opposition, sich widersetzen, Widerstand leisten, trotzen, opponieren, widersprechen
苦労 (くろう): (1) Mühe, Bemühung, Arbeit, (2) Anstrengung, Mühsal, Plackerei, Schufterei, (3) Sorgen (einer anderen Person), Kummer, Last, Mühe, (1) sich Mühe machen, sich bemühen, sich plagen, sich quälen, (2) unter Schwierigkeiten leiden, (3) sich abplagen, sich abrackern, sich abmühen, (4) sich sorgen, Sorgen haben, sich bekümmern, sich Kummer machen
電子 (でんし): Elektron
実現 (じつげん): Verwirklichung, Realisation, Realisierung, (1) verwirklichen, in die Tat umsetzen, zu Wege bringen, (2) sich verwirklichen, in Erfüllung gehen, zustande kommen, verwirklicht werden
適度 (てきど): Mäßigkeit, rechtes Maß, in Maßen, mäßig, maßvoll, gemäßigt, mäßig, maßhaltend, maßvoll
心臓 (しんぞう): (1) Herz (das Organ), (2) Unverfrorenheit, Nerven
名 (な): (1) Name, Benennung, Bezeichnung, Titel, (2) jmds. Name, (3) Ruf, Ruhm, Geltung, (4) Vorwand
休暇 (きゅうか): (1) freier Tag (meist abgesehen von Sonntag oder Feiertagen), Ruhetag, (2) Ferien, Urlaub
彼方此方 (あちこち): hier und dort, da und dort, überall, laufend, hier und dort, überall, hier und dort
ウィスキー: Whiskey, Whisky
計る (はかる): (1) messen, ausmessen, abmessen, ausloten, (2) beurteilen, messen, wiegen, ausmessen, ausloten, rechnen, berechnen, schätzen, vermuten, messen, wiegen
馬鹿 (ばか): (1) Dummkopf, Idiot, Esel, Hohlkopf, Tor, Strohkopf, (2) dumm, idiotisch, (3) Dummheit, (4) Unsinn, Quatsch, Albernheit, (5) Übertriebenheit, Riesenhaftigkeit
利口 (りこう): (1) Klugheit, Intelligenz, Gescheitheit, (2) Artigsein, Artigkeit, Bravsein, Bravheit (bei Kindern), klug, gescheit, aufgeweckt, findig, geistreich, scharfsinnig, intelligent, verständig, schlau
次第 (しだい): (1) Reihenfolge, Programm, (2) Umstände, (3) sofort, sobald, (4) je nach …
武器 (ぶき): (1) Waffe, Zeug, (2) Militär, (3) (übertr.)Waffe, Instrument, Mittel
集中 (しゅうちゅう): Konzentration, Zentralisierung, Zusammenziehen, (1) sich konzentrieren, (2) konzentrieren, zusammenziehen, sammeln
食卓 (しょくたく): Esstisch, Tisch, Tafel
満足 (まんぞく): (1) Zufriedenheit, Befriedigung, Genugtuung, (2) Angemessenheit, Vollständigkeit, (3) Erfüllung, Befriedigung (einer Bedingung, Gleichung), zufrieden sein, befriedigt sein, sich zufrieden geben, zufrieden, befriedigend, genügsam, genugtuend, vollständig, vollkommen, genug, vollauf, zur Genüge, zur Zufriedenheit
状態 (じょうたい): Situation, Umstände, Zustand, Verhältnisse, Lage
作曲 (さっきょく): Komposition, komponieren
様子 (ようす): (1) Zustand, Lage, Situation, Umstände, (2) Aussehen, Anschein, (3) Anzeichen
適切 (てきせつ): Angemessenheit, Entsprechung, angemessen, treffend, entsprechend, geeignet, passend, passend, angemessen
食欲 (しょくよく): Appetit
訪問 (ほうもん): Besuch, Aufwartung, Visite, besuchen, einen Besuch machen, aufsuchen, vorbeischauen, vorbeikommen, vorsprechen
支給 (しきゅう): Lieferung, Gewährung, Auszahlung, Versorgung, beliefern, versorgen, auszahlen
確認 (かくにん): (1) Vergewisserung, Bestätigung, Validierung, Verifikation, Bekräftigung, Feststellung, (2) OK, Bestätigung, (3) Beglaubigung, (1) sich vergewissern, sich versichern, bestätigen, bekräftigen, validieren, verifizieren, feststellen, (2) beglaubigen
母親 (ははおや): Mutter
農家 (のうか): (1) Bauernhaus, Bauernhof, (2) Bauer, Bauernfamilie
腹 (はら): (1) Bauch, Magen, Unterleib, Darm, (2) Bauch (einer Flasche), dicke Seite von etw, (3) Aufmerksamkeit, Geist, Absicht, Mut, (4) Gemüt, Gefühl, Empfindung, Inneres, Herz
切れる (きれる): (1) reißen, kaputt gehen, (2) abreißen, abbrechen, unterbrochen werden, (3) ablaufen, ausgehen, zu Ende gehen, leer werden, (4) gut schneiden, scharf sein
限界 (げんかい): Grenze, Höchstmaß, Limit
行き (ゆき): (1) Hinweg, Hinfahrt, (2) nach …., (1) Hinweg, Hinfahrt, (2) nach …
雷 (かみなり): Donner, Donnerschlag, (1) Donner, Gewitter, Blitz, (2) Donnergott, (3) Brüllen, Plärren, (4) jmd., der brüllt, Donner, Gewitter
日光 (にっこう): Nikkō (Stadt im Nordwesten der Präf. Tochigi; Zugang zum Nikkō-Nationalpark; 18.000 Ew.; buddh. Tempelanlagen, Schreine und Mausoleen für Tokugawa Ieyasu), Sonnenlicht, Sonnenschein, Sonnenstrahl
常に (つねに): immer, stets, dauernd
囲む (かこむ): (1) einschließen, einfassen, umgeben, belagern, umringen, (2) aufspeichern, einlagern, (3) spielen (Go, Shōgi, Mah-Jongg), (4) sich eine Konkubine halten
石油 (せきゆ): (1) Erdöl, Steinöl, Petroleum, (2) Kerosin
尻 (しり): (1) Gesäß, Hintern, Hinterteil, Popo, Hüfte, (2) Boden, Unterteil, Sockel, (3) Ende, hinteres Ende
予測 (よそく): Vorausberechnung, Vorhersage, Vermutung, Projektion, voraussehen, vorausberechnen, rechnen mit
組 (くみ): (1) Gruppe, Mannschaft, Bande, Team, Partei, Paar, (2) Parallelklasse, Klasse, (3) Satz, Garnitur, Paar, (4) Setzen, Satz
サイン: (1) Sinus, (2) Sinuskurve, Sinuslinie, (1) Zeichen, Signal, (2) Unterschrift, Autogramm, signieren, unterzeichnen, ein Autogramm geben
唸る (うなる): (1) stöhnen, knurren, brüllen, heulen, singen, brummen, (2) surren, schwirren, sirren, (3) im Übermaß vorhanden sein, (4) in Erstaunen versetzen
一言 (ひとこと): ein Wort, ein einziges Wort, Hitokoto, ein Wort, wenige Worte, ein Wort sagen
宇宙 (うちゅう): Universum, Kosmos, Weltall, Weltraum
お目出度う (おめでとう): Herzlichen Glückwunsch!
大屋 (おおや): Ōya, (1) Hausbesitzer, Vermieter, Wohnungseigentümer, (2) Haupthaus, Hauptgebäude, (3) Hauptzweig einer Familie
牛 (うし): (1) Rind, Kuh, Ochse, Stier, Bulle, Kalb, Bos, (2) Rind, Rindfleisch, (3) Träger (Abk. für ushi・bari), (4) giebelförmiges Gestell, gegen das Bambusbündel als Schild gegen Pfeile und Gewehrkugeln gelehnt werden
万一 (まんいち): (1) Zehntausendstel, (2) eines von zehntausend, (1) Zehntausendstel, (2) eines von zehntausend, (3) Fallmit Wahrscheinlichkeit von eins zu zehntausend, Notfall, unwahrscheinlicher Fall, Fall gegen alle Erwartungen, (4) wenn …der Fall sein sollte, im schlimmsten Fall, den äußersten Fall vorausgesetzt, (1) Zehntausendstel, (2) eines von zehntausend, (3) Fall mit Wahrscheinlichkeit von eins zu zehntausend, Notfall, unwahrscheinlicher Fall, Fall gegen alle Erwartungen, (4) wenn …der Fall sein sollte, im schlimmsten Fall, den äußersten Fall vorausgesetzt, (1) Zehntausendstel, (2) eines von zehntausend, (3) Fallmit Wahrscheinlichkeit von eins zu zehntausend, Notfall, unwahrscheinlicher Fall, Fall gegen alle Erwartungen, (4) wenn …der Fall sein sollte, im schlimmsten Fall, den äußersten Fall vorausgesetzt
見解 (けんかい): (1) Meinung, Ansicht, Stellungnahme, (2) Bewertung, Beurteilung, Werturteil, (3) Deutung, Auffassung
裁判 (さいばん): (1) Prozess, Verhandlung, (2) Entscheiden, Urteilen, (3) Entscheidung, Urteil, (4) Gericht, (5) Führen der Geschäfte, Handhabung von Angelegenheiten, Gericht halten, ein Urteil fällen
内容 (ないよう): Inhalt, Gehalt, Enthaltene, Substanz, Kern, Tiefe
明らか (あきらか): (1) offensichtlich, offenbar, klar, deutlich, hell, (2) einleuchtend, augenscheinlich, (3) gewiss, ohne Zweifel, sicher, (1) deutlich, klar, (2) augenscheinlich, einleuchtend, sichtbar, (3) ohne Zweifel, gewiss, sicher, unbezweifelt, klar, deutlich, offenbar, augenscheinlich, gewiss, sicher
飼う (かう):  (Tiere) halten, züchten
記入 (きにゅう): Eintragung, Buchung, Einschreiben, Vermerk, eintragen, aufschreiben,  (Formular) ausfüllen, buchen, einschreiben, notieren, vermerken, einen Vermerk machen
人生 (じんせい): menschliches Leben, Menschenleben, Leben
根 (ね): (1) Wurzel, (2) Grund, Ursprung, (3) Natur, Charakter
市場 (いちば): Markt, Marktplatz (der Ort, nicht die abstrakte Bedeutung)
人類 (じんるい): Menschheit, Mensch, Menschengeschlecht, Menschentum
双子 (ふたご): Zwillinge
真っ赤 (まっか): (1) Hochrot, Knallrot, Feuerrot, Blutrot, (2) Unverfrorenheit (einer Lüge), (1) hochrot, knallrot, feuerrot, blutrot, (2) unverfroren, faustdick (eine Lüge)
今に (いまに): (1) in naher Zukunft, bald, binnen kurzem, demnächst, dieser Tage, früher oder später, gleich, in absehbarer Zeit, (2) bis jetzt, noch, (3) noch nicht (bei Verneinung)
木曜 (もくよう): Donnerstag
責める (せめる): (1) zur Rechenschaft ziehen, zur Verantwortung ziehen, ins Gebet nehmen, (2) quälen, foltern, misshandeln, peinigen, kujonieren, (3) drängen, auffordern, (4) zureiten (ein Pferd)
独立 (どくりつ): Unabhängigkeit, Selbständigkeit, Freiheit, unabhängig werden, unabhängig, nicht abhängig
掲示 (けいじ): Anschlag, Aushang, Plakat, Bekanntmachung, Aufgebot, einen Anschlag machen
題 (だい): (1) Thema, Gegenstand, (2) Titel, Überschrift, (3) Aufgabe, Frage, Problem, (4) (Zählwort für)Fragen
札 (さつ): Banknote, Papiergeld, Geldschein
館 (かん): großes Gebäude, Schloss, Villa
抱える (かかえる): (1) in den Armen tragen, (2) haben, zu tragen haben (Probleme, Belastungen), (3) jmdn. anstellen, jmdn. einstellen
分ける (わける): (1) aufteilen, teilen, abteilen, zerteilen, trennen, (2) scheiteln, (3) verteilen, austeilen, aufteilen, zuteilen, (4) aussortieren, trennen, absondern, auf die Seite legen, (5) einteilen, sortieren, klassifizieren
消費 (しょうひ): Verbrauch, Konsum, Verzehr, verbrauchen, konsumieren, verzehren
再び (ふたたび): wieder, erneut, abermals, noch einmal, zweimal
守る (まもる): (1) beschützen, verteidigen, bewachen, eskortieren, (2) befolgen, einhalten, halten, (3) gehorchen, sich unterwerfen
直接 (ちょくせつ): Unmittelbarkeit, Unvermitteltheit, Direktheit, direkt, unmittelbar, unvermittelt
泥 (どろ): (1) Schlamm, Schmutz, Dreck, Kot, (2) Dieb, Räuber, Einbrecher, (3) Diebstahl, Einbruch (Abk.)
遅刻 (ちこく): Verspätung, sich verspäten, zu spät kommen
チーム: Team, Mannschaft
支店 (してん): Zweiggeschäft, Zweigniederlassung, Filiale
離す (はなす): (1) abtrennen, absondern, scheiden, abreißen, abschneiden, abstoßen, losmachen, trennen, entfernen, auseinanderhalten, loslassen, abhängen, entkuppeln, (2) (seinen Blick) abwenden
絶滅 (ぜつめつ): (1) Ausrottung, Vernichtung, Vertilgung, (2) Aussterben, (1) ausrotten, vertilgen, (2) aussterben
用いる (もちいる): (1) benutzen, gebrauchen, (2) annehmen, (3) anstellen
麦酒 (ばくしゅ): Bier
不思議 (ふしぎ): (1) Wunder, Mysterium, Geheimnis, etw. Wunderbares, Rätsel, Wundertat, übernatürliches Ereignis, (2) Fragwürdigkeit, Bedenklichkeit, Unsicherheit, wundersam, wunderbar, merkwürdig, seltsam, geheimnisvoll, mysteriös, übernatürlich
睡眠 (すいみん): Schlaf
酸素 (さんそ): Sauerstoff, Oxygen, Oxygenium (chem. Element; Zeichen: O)
適用 (てきよう): Anwendung, Verwendung, anwenden
ジーンズ: (1) Jeans, (2) Jeansstoff, James Hopwood Jeans (brit. Mathematiker, Physiker und Astronom; 1877–1946)
スイッチ: Weiche, Schalter (relativ ungewöhnliche Schreibung für swi), (1) Schalter, elektrischer Schalter, (2) Weiche, (3) Austauschen, Wechseln, (4) Switch, Switching Hub
勘 (かん): (1) Intuition, sechster Sinn, Spürsinn, Fingerspitzengefühl, instinktives Gefühl, (2) ausführliches Überprüfen und Nachdenken, Untersuchung eines Verbrechens
我慢 (がまん): (1) Geduld, Langmut, Ausdauer, Toleranz, Duldsamkeit, Selbstbeherrschung, (2) Stolz, Arroganz, Überheblichkeit, Selbstüberschätzung, Missachtung anderer, (3) Selbstsucht, Starrsinn, (4) Tätowierung, Geduld haben (mit …), geduldig sein, erdulden, ertragen
飛ばす (とばす): (1) fliegen lassen, (2) schnell fahren, beschleunigen, (3) vollspritzen, (4) überspringen, (5) verbreiten (Gerücht)
得る (うる): (1) gewinnen, erwerben, bekommen, finden, (2) können
書物 (しょもつ): Bücher, Schriften
都市 (とし): Stadt, städtisch, urban
合計 (ごうけい): Summe, Gesamtbetrag, Gesamtsumme, Endbetrag, zusammenrechnen, zusammenzählen
設備 (せつび): Einrichtung, Ausstattung, Ausrüstung, Anlage, einrichten, ausstatten, ausrüsten, anlegen
ホーム: (1) Heim, Familie, (2) Homebase, Schlagmal, (3) Kinderheim, Altenheim, Pflegeheim, Bahnsteig, Plattform
宿 (やど): Herberge, Unterkunft, Gasthof, Hotel
快適 (かいてき): Behaglichkeit, Bequemlichkeit, angenehm, erfreulich, bequem, behaglich, gemächlich, erfrischend, erquickend, in behaglicher Weise
一度に (いちどに): (1) gleichzeitig, zugleich, zu gleicher Zeit, zusammen, (2) auf einmal, mit einem Mal, in einem Zug
暗記 (あんき): Auswendiglernen, Memorieren (damit man etw. auswendig aufsagen kann), auswendig lernen, auswendig aufsagen
不図 (ふと): (1) sofort, auf der Stelle, (2) leicht, mit Leichtigkeit, (3) plötzlich, unerwartet, (4) zufällig, zufälligerweise
詳しい (くわしい): (1) ausführlich, eingehend, genau, detailliert, (2) versiert sein, bewandert sein, gut kennen, gut Bescheid wissen
バイオリン: Violine, Geige, Violine
冗談 (じょうだん): Scherz, Spaß, Witz, im Spaß, als Witz
スピーチ: Rede, Ansprache, Vortrag
図 (ず): (1) Bild, Abbildung, Illustration, Entwurf, Zeichnung, Plan, Skizze, Diagramm, Karte, Schema, (2) Anblick, (3) Anmaßung
勤め (つとめ): (1) Pflicht, Dienst, Beruf, (2) Gottesdienst, Sūtren-Rezitation
仲 (なか): Naka, Freundschaft, persönliches Verhältnis, persönliche Beziehungen
評判 (ひょうばん): (1) Ruf, Reputation, Leumund, (2) Popularität, Berühmtheit, traurige Berühmtheit, (3) Gerücht, Gerede, (1) populär, (2) berühmt, notorisch, (3) viel diskutiert
同僚 (どうりょう): Kollege, Mitarbeiter, Kamerad, Gefährte, Genosse
豊富 (ほうふ): Reichtum, Fülle, Menge, Überfluss, reich, reichlich, üppig, in Hülle und Fülle, in Mengen, im Überfluss, in Hülle und Fülle, in Mengen, im Überfluss, reichlich
高価 (こうか): hoher Preis, Kostspieligkeit, Kostspieligkeit, teuer, kostspielig
キャプテン: Chef, Führer, Leiter, Kapitän
端 (はし): (1) Kante, Ende, Ecke, Spitze, Rand, Saum, (2) Teil einer Sache, Kleinigkeit, (1) Anfang, Beginn, (2) Ende, Spitze, Nase
だって: (1) weil, (2) aber, na hör mal
事情 (じじょう): Umstände, Sachlage, Lage, Verhältnisse, Grund
地域 (ちいき): (1) Bezirk, Bereich, Zone, Gebiet, Landstrich, Gegend, Raum, (2) Land, ländliches Gebiet
教授 (きょうじゅ): (1) Unterricht, Vorlesung, Lektion, (2) Professor, Ordinarius, unterrichten, Unterricht geben, Vorlesung halten, Stunden geben
模様 (もよう): (1) Muster, Zeichnung, Aufdruck, Design, (2) Aussehen, Aussicht, Situation, Lage, Umstände, Verhältnisse
県 (けん): (1) Präfektur, Provinz, Ken, (2) ehemaliges Han (in der Übergangszeit, als Han durch Ken ersetzt wurden und noch nicht neu eingeteilt waren), (3) Kreis (in China Verwaltungseinheit unter chin. zhou 州, chin. fu 府 oder chin. dao 道)
禁煙 (きんえん): (1) Rauchverbot, (2) Rauchen verboten! (als Schildaufschrift), (3) Aufhören zu Rauchen, (4) Verbot von Feuer zum Kochen (in China; am 105 Tag nach der Wintersonnenwende, weil man sagt, dass an diesem Tag Wind und Regen heftig sind), das Rauchen aufgeben
柄 (え): Handgriff, Griff, Stiel, Heft, Kurbel, Schwengel
農民 (のうみん): Bauer
プラン: Plan, Entwurf, Vorhaben, Projekt
生じる (しょうじる): (1) erzeugen, hervorbringen, hervorrufen, verursachen, (2) entstehen, geschehen
暮れ (くれ): (1) Abenddämmerung, Eintritt der Dunkelheit, Einbruch der Nacht, Sonnenuntergang, (2) Ende, Schluss, (3) Jahresende, Ende des Jahres
慎重 (しんちょう): Bedachtsamkeit, Umsicht, Sorgfalt, Vorsicht, umsichtig, behutsam, vorsichtig
数字 (すうじ): Zahl, Ziffer
役 (やく): (1) Dienst, Position, Amt, (2) Rolle, Führer, Aufgabe, (3) Bühnenrolle, (4) Wirkung, Nutzen, (5) Hand
日常 (にちじょう): Alltag, tägliches Leben, alltäglich, gewohnt, gewöhnlich
容易 (ようい): Leichtigkeit, Einfachheit, Mühelosigkeit, leicht, einfach, mühelos
巨大 (きょだい): (1) Riesenhaftigkeit, Gigantismus, (2) etw. Riesengroßes, (3) riesengroß, gigantisch, kolossal, ungeheuer, riesig, riesengroß, ungeheuer, gigantisch, monströs, kolossal, gigantisch, titanisch, großangelegt, Riesen…
勧める (すすめる): (1) raten, zureden, (2) anbieten, (3) anregen, ermutigen, ermuntern, (4) empfehlen, befürworten, empfehlen, raten, anbieten
価値 (かち): Wert, Wertschätzung, Geltung, Güte, Würde, Verdienst
神経 (しんけい): (1) Nerv, (2) Nerven, Sensibilität, nervlich, nervös
戻す (もどす): (1) zurückgeben, wiedergeben, wiederbringen, zurücksenden, zurücklegen, zurückzahlen, (2) zurückstellen, rückgängig machen, wiederherstellen, zurückfahren, (3) abweisen, zurückweisen, (4) sich übergeben, sich erbrechen
噂 (うわさ): (1) Gerücht, Gerede, Stadtgespräch, Klatsch, Hörensagen, (2) Gespräch über einen Abwesenden
クリスマス: Weihnachten
差別 (さべつ): (1) Unterschiedlichkeit, (2) Unterschied, Unterscheidung, Diskriminierung (alte Aussprache für sabetsu), Unterschied, Unterscheidung, Diskriminierung, unterscheiden, diskriminieren
市 (いち): Markt, Marktplatz, Markttag, Messe
熱帯 (ねったい): Tropen (heiße Zonen beiderseits des Äquators zwischen den Wendekreisen)
グランド: groß
方向 (ほうこう): (1) Richtung, Kurs, (2) Ziel
中心 (ちゅうしん): (1) Zentrum, Mittelpunkt, Mitte, (2) Kern, Innerstes, Herz, (3) Balance, Gleichgewicht, zentral, mittel
一人一人 (ひとりひとり): einzeln, einer nach dem andern, jeder, jeder einzelne, einzeln, jeder, einer nach dem andern
関連 (かんれん): Zusammenhang, Beziehung, Verbindung, zusammenhängen, in Zusammenhang stehen, sich beziehen auf, zu tun haben mit
事務 (じむ): Geschäft, Verwaltung, Büroarbeit, Schreibtischarbeit
アウト: (1) Aus,  (österr.)Out, (2) aus, out, außerhalb des Spielfeldes, (3) ins Aus gegangener Ball, (4) die ersten neun Löcher (eines Golfplatzes mit 18 Löchern), (5) Außen, (6) Ausfallen, Misserfolg
列 (れつ): Reihe, Schlange, Zug, Prozession, Umzug, Queue, Linie
贈る (おくる): schenken, beschenken, ein Geschenk machen, bescheren
大戦 (たいせん): (1) großer Krieg, (2) Weltkrieg (Abk.)
偉大 (いだい): Größe, Hervorragendheit, Mächtigkeit, Größe, Großartigkeit, Mächtigkeit, Macht, Gewalt, Grandeur, groß, großartig, mächtig, gewaltig
いらっしゃい: (1) Willkommen!, (2) Herzlich willkommen!, (3) Bitte!
老人 (ろうじん): Betagter, alter Mann, alte Frau, alte Leute
可 (か): (1) Möglichkeit, (2) Akzeptieren, Für-gut-Erklären, (3) genügend (z.B. als Note), bestanden
流行 (はやり): (1) Mode, Trend, letzter Schrei, Zeitgeschmack, Fashion, (2) Umsichgreifen, Grassieren, (1) Mode, Trend, der letzte Schrei, neuster Geschmack, Zeitgeschmack, Fashion, Beliebtheit, (2) Verbreitung, Überhandnahme, Umsichgreifen, Vorherrschen, (3) Epidemie, (1) in Mode sein, im Schwange sein, in Mode kommen, (2) überhandnehmen, um sich greifen, überhand nehmen, vorherrschen, (1) modisch, modegerecht, nach der Mode, (2) epidemisch, um sich greifend, überhandnehmend, Mode…
追いつく (おいつく): einholen, aufholen, erreichen, nachholen
平均 (へいきん): (1) Durchschnitt, (2) Gleichgewicht, Balance, den Durchschnitt ziehen, den Durchschnitt berechnen, das Mittel nehmen
板 (いた): Brett, Holzbrett, Planke, Bohle, Tafel, Diele
交換 (こうかん): (1) Tausch, Tauschhandel, (2) Austausch, (3) Umtausch, Ersatz, Ersetzung, austauschen
途端 (とたん): gerade als, unmittelbar danach
泳ぎ (およぎ): Schwimmen
身長 (しんちょう): Körpergröße, Größe
分析 (ぶんせき): Analyse, Zerlegung, Erzprobe, analysieren
濃い (こい): (1) dunkel (Farbe), (2) kräftig (Farbton), (3) stark (z.B. Kaffee), konzentriert, (4) stark (Geschmack), schwer (Geruch), dick (Schminke), (5) dicht (Verbreitung, Bewuchs, Nebel), dick, (6) eng, innig, vertraut, nah, intim (Beziehung zwischen Mann und Frau), (7) hoch (Möglichkeit, Wahrscheinlichkeit), wahrscheinlich, unvermeidbar
縄 (なわ): (1) Seil, Tau, Strick, Leine, (2) Festnahme
劇 (げき): Schauspiel, Drama, Theater
生き物 (いきもの): Lebewesen, Geschöpf, Kreatur
型 (かた): (1) Form, Gussform, Matritze, Schnittmuster, (2) Modell, Typ, Stil, Format, (3) überlieferte Form, (4) Kata, vorgegebene Ausführungsform, (5) (vorgeschriebene)Größe, Gruppe, Modell, Typus
茶 (ちゃ): (1) Tee, grüner Tee, (2) Teezeremonie, (3) Nachmittagskaffee, (4) Braun, (5) Necken, Foppen
犯人 (はんにん): Verbrecher, Täter, Krimineller, Beschuldigter
若しも (もしも): wenn …, falls …, im Falle, dass …, angenommen, dass …, vorausgesetzt, dass …
農業 (のうぎょう): Landwirtschaft, Ackerbau, Agrikultur, landwirtschaftlich, Agrar…
競技 (きょうぎ): (1) Wettkampf, Wettbewerb, Spiel, (2) Sportwettkampf, Sport, Wettkampfsport
粉 (こな): Mehl, Pulver, Mehl, Pulver, Staub
何時までも (いつまでも): für immer
結果 (けっか): (1) Ergebnis, Folge, Resultat, Frucht, Ausgang, Wirkung, Erfolg, (2) Tragen, Früchtetragen
前者 (ぜんしゃ): der Erstere, jener
本物 (ほんもの): (1) Echtheit, Unverfälschtheit, Original, (2) hervorrragende Vorstellung, echt, unverfälscht
握手 (あくしゅ): (1) Handschlag, Händedruck, (2) Versöhnung, (3) Zusammenarbeit, Kooperation, die Hand geben, die Hand reichen, die Hand drücken, Hände schütteln
全く (まったく): (1) völlig, gänzlich, ganz, vollständig, (2) wirklich, tatsächlich
連続 (れんぞく): (1) Fortsetzung, Aufeinanderfolge, Fortdauer, Serie, Kontinuität, (2) Stetigkeit, fortlaufen, dauern, aufeinander folgen, sich fortsetzen
承認 (しょうにん): Anerkennung, Zustimmung, Einverständnis, Billigung, anerkennen, zustimmen
完成 (かんせい): Fertigstellung, Abschluss, Vollendung, Vervollkommnung, Ausarbeitung, Vervollständigung, vollenden, zur Vollendung bringen, ausarbeiten, vervollkommnen, vervollständigen, vollendet sein
装置 (そうち): (1) Vorrichtung, Einrichtung, Apparat, Anlage, Ausrüstung, (2) Gerät, Einheit, eine Vorrichtung anbringen, einrichten, ausstatten
かも知れない (かもしれない): (1) vielleicht, eventuell, möglicherweise, unter Umständen, kann sein, (2) ich fürchte, dass …, nicht ausgeschlossen, dass …, möglich, dass …
必死 (ひっし): (1) sicherer Tod, gewisser Tod, unvermeidlicher Tod, (2) Verzweiflung, verzweifelt, in Verzweiflung, äußerst angestrengt, verzweifelt, rasend, aus Leibeskräften, ungestüm
程度 (ていど): (1) Grad, Umfang, Format, Ausmaß, Ausdehnung, (2) Niveau, Stufe, (3) Grenze, (4) ungefähr
男の人 (おとこのひと): Mann
表現 (ひょうげん): (1) Ausdruck, Formulierung, Darstellung, (2) Darstellung, ausdrücken, formulieren
相手 (あいて): (1) Partner, Kamerad, Kollege, Freund, (2) der Andere, Gegner, Gegenspieler, Antagonist, Konkurrent, (3) Objekt, (4) anderer Teil eines Paares, Pendant
面 (おもて): (1) Gesicht, (2) Oberfläche, (1) Gesicht, Antlitz, (2) Oberfläche, (3) Maske, Larve, (4) Ansehen, Würde
新鮮 (しんせん): Frische, Neuheit, Frische, frisch, neu
田 (た): Reisfeld
製造 (せいぞう): Herstellung, Erzeugung, Produktion, Fertigung, Fabrikation, herstellen, fertigen, erzeugen, fabrizieren, produzieren
空き (あき): (1) Lücke, Leere, (2) freier Raum, leerer Raum, Zwischenraum, Spielraum, freie Zeit, (3) freie Stelle, Vakanz
行動 (こうどう): (1) Handeln, Handlung, Tun, Verhalten, Aktivität, Aktion, Maßnahme, (2) Benehmen, (1) handeln, tun, tätig sein, wirken, arbeiten, (2) sich verhalten, sich benehmen
城 (しろ): Schloss, Burg, Festung, Fort, Zitadelle
長期 (ちょうき): lange Frist, langer Termin
職業 (しょくぎょう): Beruf, Gewerbe, Profession, Stelle, Arbeit
豆 (まめ): (1) Bohne, Erbse, Hülsenfrüchte (insbes.)Sojabohnen, (2) Blase (an den Füßen, Händen o.Ä.)
スープ: Suppe
欠陥 (けっかん): Mangel, Fehler, Defizit, Unvollständigkeit
必ずしも (かならずしも): nicht immer
表 (ひょう): Tabelle, Liste, Grafik, Tafel, Diagramm
通す (とおす): (1) durchlassen, durchgehen lassen, vorübergehen lassen, durchgeben, (2) führen, eintreten lassen, (3) durchschlagen, durchbohren, durchdringen, (4) durchsetzen, durchbringen, (5) fortsetzen, fortführen, (6) sich ausgeben für …, sich … stellen
注文 (ちゅうもん): (1) Bestellung, Auftrag, Order, (2) Forderung, Bedingung, Wunsch, Anspruch, (1) bestellen, eine Bestellung aufgeben, in Auftrag geben, einen Auftrag erteilen, (2) machen lassen (z.B. Anzug, Schuhe), (3) fordern
苦痛 (くつう): Schmerz (körperlich und geistig), Weh, Pein, Qual, Leid, Leiden
強調 (きょうちょう): Betonung, Emphase, Nachdruck, Akzent, betonen, akzentuieren, hervorheben, unterstreichen, bekräftigen
野 (の): Feld, Flur, (1) Feld, Gebiet, Areal, (2) Opposition
税 (ぜい): (1) Steuer, Zoll, (2) Wegegeld, Brückengeld
哲学 (てつがく): Philosophie, Weltanschauung
胸 (むね): (1) Brust, Brustkasten, (2) Busen, Brüste, (3) Herz, (4) Lunge, (5) Magen, (6) Sodbrennen, (7) Herz, Gemüt, Seele, (8) Brustteil
貧しい (まずしい): (1) arm, armselig, bedürftig, mittellos, notleidend, (2) unbegabt, arm an Begabung
尊重 (そんちょう): Achtung, Wertschätzung, Respekt, achten, hochachten, hochschätzen, ehren, in Ehren halten, respektieren, schätzen
性格 (せいかく): (1) Charakter, Wesen, Persönlichkeit, (2) Natur, Charakter
任せる (まかせる): (1) überlassen, anvertrauen, anheim geben, jmds. Sorge überlassen, (2) einen anderen tun lassen, wie er will, (3) keinen eigenen Willen haben, (4) sich ergeben, sich fügen
過去 (かこ): (1) Vergangenheit, Vorleben, (2) Imperfekt, (3) vergangene Welt, (4) jmds. vorheriges Leben, in der Vergangenheit, einst, früher
親しい (したしい): (1) freundschaftlich, befreundet, vertraut, (2) innig, intim, gut, eng, (3) in enger Beziehung stehend, mit einander verwandt, (4) persönlich, direkt (eine hochrangige Person)
布 (ぬの): Tuch, Stoff, Zeug
金融 (きんゆう): (1) Finanzierung, Kreditgewährung, (2) Finanzen, Finanzwesen, Geldwesen, Vermögenslage, finanzielle Verhältnisse, (3) Finanz…, Geld…
頂戴 (ちょうだい): (1) Erhalten, Empfangen, (2) Essen, (3) Bitte!, (1) erhalten, empfangen, bekommen, (2) essen
悲しむ (かなしむ): betrauern, trauern, traurig sein, sich grämen, sich betrüben, jammern, bejammern, klagen, bedauern, beweinen
愉快 (ゆかい): Spaß, Vergnügen, Freude, Fröhlichkeit, fröhlich, freudig, heiter, lustig, in fröhlicher Weise, freudig, heiter, lustig
生 (せい): Leben, Existenz, Leben, Lebendigkeit
機嫌 (きげん): (1) Laune, Stimmung, Verfassung, Gemütszustand, (2) Befinden, Gesundheitszustand, (3) Abneigung, (4) Umstände, Sachlage, (5) Gelegenheit, rechte Zeit, günstiger Zeitpunkt, (6) gute Stimmung (bes. in der Form go・kigen)
とん: nichts, nicht vollständig
人物 (じんぶつ): (1) Person, Mensch, Persönlichkeit, Figur, Seele, Wesen, Geist, Charakter, (2) Person von Geist, Person von Format, (3) Charakter (in einem Roman), Rolle (in einem Theaterstück oder Film)
都会 (とかい): Stadt, Großstadt, städtisch
愛 (あい): (1) Liebe, Liebesgefühle, Zuneigung, Sympathie, Anhänglichkeit, (2) (geschlechtliche)Liebe, Eros, (3) Wertschätzung, Gernhaben, Mögen, (4) Liebenswürdigkeit, Umgänglichkeit, (5) Trauer, (6) sinnliche Liebe, Leidenschaft, Lust, (7) Agape, Liebe Gottes zu den Menschen, (8) Irland (Abk.), Ai
大いに (おおいに): (1) sehr, viel, ansehnlich, beachtlich, beträchtlich, wesentlich, (2) in großem Umfang, in hohem Maße
鍋 (なべ): (1) Topf, Kochtopf, Pfanne, Kessel, Nabe, (2) Eintopfgericht, Eintopf, Nabegericht (Abk.)
辛い (つらい): (1) bitter, schmerzlich, (2) hart, mühsam, anstrengend, (3) schwer, schwierig
ソファ: Sofa
こんなに: so, so sehr, wie dies
多少 (たしょう): (1) viel oder wenig, mehr oder weniger, (2) etwas, ein wenig, (3) einige, wenige
駐車 (ちゅうしゃ): Parken,  (schweiz.)Parkieren, parken,  (schweiz.) parkieren
現金 (げんきん): (1) Geld, Bargeld, (2) Berechnung, (3) eigennützig, berechnend, gierig, Eigennützigkeit, Gier, berechnend, gewinnsüchtig, bar
孫 (まご): Enkel, Enkelin, Enkelkind
年月 (としつき): Jahre
苛々 (いらいら): (1) (2) , nervös sein, gereizt werden, erregt sein, ungeduldig werden, die Geduld verlieren
膝 (ひざ): (1) Knie, (2) Schoß
課 (か): (1) Lektion … (Zählwort für Lektionen), (2) Abteilung, Departement
確実 (かくじつ): Gewissheit, Verlässlichkeit, Sicherheit, Genauigkeit, Gewissheit, Sicherheit, Genauigkeit, (1) sicher, (2) verlässlich, sicher, sicherlich
観光 (かんこう): (1) Fremdenverkehr, Tourismus, (2) Besichtigung von Sehenswürdigkeiten, Sightseeing, (3) Satin, Sehenswürdigkeiten besichtigen, Sightseeing betreiben
幸福 (こうふく): Glück, Glücklichkeit, Glückseligkeit, Zufriedenheit, Wohlergehen, Heil, Seligkeit, Segen, glücklich, glückselig, beglückt, selig, freudevoll, begünstigt, gesegnet, gnadenvoll, gnädig, segensreich, glücklich, zum Glück, glücklicherweise
尊敬 (そんけい): Achtung, Ehrerbietung, Respekt, Verehrung, achten, Achtung haben, in Ehren halten, respektieren
技 (わざ): (1) Technik, Geschicklichkeit, Fähigkeit, Kunstfertigkeit, (2) Kunstgriff, Trick, (3) Technik, Würfe, Haltegriffe und Hebel
建設 (けんせつ): (1) Bau, Aufbau, Errichtung, Schaffung, (2) Hausbau, bauen, aufbauen
永遠 (えいえん): (1) Ewigkeit, Zeitlosigkeit, Permanenz, (2) Ewigkeit, für immer, auf immer, in alle Ewigkeit, ewig, bleibend, permanent, zeitlos, unsterblich, dauernd
デート: Rendezvous, Stelldichein, Date, ein Rendezvous haben
凍る (こおる): gefrieren, zufrieren, zu Eis werden, vereisen, gerinnen, zum Gerinnen kommen
金庫 (きんこ): (1) Schatzkammer, (2) Geldschrank, Safe, (3) Schatzamt, (4) Bank, Kasse, Kreditanstalt
物音 (ものおと): Geräusch, Ton
辞める (やめる): sein Amt niederlegen, aufhören, abdanken, sich zurückziehen, zurücktreten, zurücktreten
マスター: (1) Magister, (2) Chef, Manager, Boss, Prinzipal, (3) Beherrschung, (4) Original, Master, (1) Magister, (2) Chef, Manager, Boss, Prinzipal, (3) Beherrschung, (4) Original, Master, beherrschen
家具 (かぐ): Möbel, Möbelstück, Mobiliar, Zimmereinrichtung (wie Schrank, Tisch, Stuhl etc.)
ライター: (1) Autor, Schriftsteller, Verfasser, (2) Schreiber, Feuerzeug, Zigarettenanzünder
兎に角 (とにかく): (1) jedenfalls, auf jeden Fall, auf alle Fälle, immerhin, sowieso, (2) abgesehen davon, dass ….
正直 (しょうじき): Ehrlichkeit, Aufrichtigkeit, Redlichkeit, Rechtschaffenheit, ehrlich, aufrichtig, redlich, rechtschaffen, in ehrlicher Weise, ehrlich, redlich, aufrichtig, rechtschaffen
年中 (ねんじゅう): (1) jahraus, jahrein, (2) das ganze Jahr hindurch, (3) immer, (4) Midis, Vierjährigen (im Kindergarten usw.), (1) jahraus, jahrein, (2) das ganze Jahr hindurch, (3) immer
攻撃 (こうげき): (1) Angriff, Attacke, Aggression, Offensive, Sturm, Sturmangriff, (2) Kritik, Angriff, Vorwurf, Verurteilung, Missbilligung, (3) Offensive, Angriff, Sturm, (4) Schlagen, angreifen, attackieren, anfallen, angehen, stürmen, einen Sturmangriff machen, anspringen, die Offensive ergreifen, verurteilen, kritisieren
一致 (いっち): (1) Übereinstimmung, Übereinkommen, Einigung, (2) Übereinstimmung, Kongruenz, (3) Einstimmigkeit, Einmütigkeit, Kooperation, Einigkeit, (4) Zustimmung, Einwilligung, (1) übereinstimmen, übereinkommen, einig sein, in Einklang stehen, entsprechen, (2) übereinstimmen, kongruieren
性 (せい): (1) Natur, (2) Sexualität, Sex, (3) Geschlecht, (4) Geschlecht, Genus, (5) Eigenschaft
設計 (せっけい): Plan, Entwurf, Design, Projekt, planen, entwerfen, projektieren, anlegen
食糧 (しょくりょう): Nahrungsmittel, Lebensmittel, Proviant
生命 (せいめい): (1) Leben, Leib und Leben, Existenz, (2) Seele, wichtigster Teil
お前 (おまえ): du, Ihr (in der modernen japan. Sprache abwertende Anrede; im altsprachlichen Japanisch jedoch eine höfliche Anrede), du (unhöfliche Anrede für einen Rangniederen)
連想 (れんそう): Assoziation, Verbindung, Gedankenverbindung, Ideenverbindung, assoziieren, erinnern, verbinden
誘う (さそう): einladen, verursachen, (1) einladen, auffordern, bitten zu, abholen, veranlassen, (2) locken, verlocken, verführen, verleiten, versuchen
鎖 (くさり): Kette
ワイン: Wein
恐ろしい (おそろしい): (1) furchterregend, furchteinflößend, beängstigend, (2) furchtbar, fürchterlich, schrecklich, entsetzlich, grässlich, grausig, (3) zu beachtend, zu vermeidend, (4) gefährlich, bedrohlich, (5) gewaltig, enorm, ungeheuer, (6) mysteriös, seltsam, unerklärlich
只 (ただ): (1) umsonst, unentgeltlich, gratis, (2) gewöhnlich, normal, einfach, (3) bloß, nur, nichts als, nur, bloß, nichts als, gewöhnlich, normal, einfach
青年 (せいねん): Jugendlicher, junger Mann, junge Frau, junge Leute, Jugend
放す (はなす): (1) loslassen, entlassen, entbinden, freigeben, (2) freilassen, befreien
部分 (ぶぶん): Teil, Portion, Abschnitt
残り (のこり): (1) Rest, Überrest, Überbleibsel, (2) Überschuss, (3) Rückstände, verbleibend, übriggeblieben, restlich, zurückbleibend, überschüssig
予算 (よさん): (1) Voranschlag, vorläufige Kostenberechnung, (2) Etat, Budget, Haushalt, budgetär, Budget…
議論 (ぎろん): (1) Argument, Erklärung, Darlegung, (2) Diskussion, Debatte, Rede und Gegenrede, Aussprache, Disputation, Kontroverse, Meinungsaustausch, diskutieren, debattieren, sich auseinandersetzen, sich aussprechen, erörtern, disputieren, Meinungen austauschen, verhandeln
有能 (ゆうのう): Fähigkeit, Kompetenz, Tüchtigkeit, fähig, befähigt, kompetent, brauchbar, gewandt, tüchtig
修理 (しゅうり): Reparatur, reparieren
大使 (たいし): (1) Botschafter, (2) Anführer einer Gesandtschaft oder eines Expeditionsheeres
地区 (ちく): Bezirk, Gebiet, Region, Zone
労働 (ろうどう): Arbeit, körperliche Arbeit, arbeiten
ピン: (1) Stecknadel, Haarnadel, (2) Anstecknadel, Schmucknadel, Krawattennadel, Brosche, (3) Schmiernippel, (4) Kegel, (5) Flaggenstock
ちゃんと: (1) ordentlich, brav, (2) gründlich, pünktlich
其処で (そこで): dort, dann, darauf, daher, darum, deshalb, nun
勝ち (かち): Sieg, Gewinn
何時か (いつか): (1) irgendwann, eines Tages, (2) einmal, einst, neulich, kürzlich, vor kurzem
ミルク: (1) Kuhmilch, Milch, (2) Kondensmilch
其の儘 (そのまま): (1) wie es ist, einfach so, im ursprünglichen Zustand, (2) ohne Unterbrechung, (3) genau wie, ähnlich
流す (ながす): (1) fließen lassen, strömen lassen, gießen, vergießen, schütten, (2) abwaschen, (3) verbreiten (Gerüchte, Informationen), (4) ausstrahlen, aussenden (Fernseh- und Radioprogramm), (5) verbannen, ins Exil schicken, exilieren, (6) herumfahren, herumziehen, (7) verfallen lassen (ein Pfand), (8) absagen, ausfallen lassen
トランプ: Spielkarte (trumpbedeutet eigentl. Trumpf)
霜 (しも): Frost, Reif, Raureif
祝い (いわい): (1) Gratulation, Glückwunsch, Feier, Fest, Schmaus, Festessen, (2) Geschenk
まあ: (1) mal, nun, (2) Oh!, (3) Ach!, (4) Äh!
真似 (まね): (1) Nachahmung, Nachäffung, Imitation, (2) Verhalten, nachahmen, imitieren, nachmachen, nachäffen
世紀 (せいき): Jahrhundert
割る (わる): (1) teilen, spalten, zerbrechen, (2) aufteilen, verteilen, (3) teilen, dividieren, (4) entzweien, trennen, (5) auseinanderschieben, (6) verdünnen, vermischen, verschneiden, (7) unter … fallen, unter einen Standard fallen (Mengen, Preise, Kurse), (8) (eine Wunde) öffnen, einen Riss in der Haut zufügen, (9) eine Grenzlinie übertreten, (10) diskontieren (einen Scheck), zerbrechen, (11) fallen (Preise, Aktienkurse), (12) kaputtmachen, zerstören, vernichten
語る (かたる): (1) erzählen, berichten, (2) eine Geschichte erzählen, (3) ausführlich erklären, (4) vertraulichen Umgang haben, befreundet sein
何で (なんで): warum, wieso, womit
新た (あらた): neu, frisch, neuartig, (1) neu, frisch, neuartig, (2) erneut, erneut, wieder, aufs Neue, noch einmal
軈て (やがて): (1) bald, demnächst, binnen kurzem, in nächster Zeit, (2) nach kurzem, kurz danach, nach einer kleinen Weile, (3) fast, beinahe, nahezu, (4) letztendlich, letzen Endes, schließlich, schlussendlich
湾 (わん): Bucht, Golf
にっこり: lächelnd, mit einem Lächeln
意思 (いし): Absicht, Vorsatz, Vorhaben, Gedanke, Idee, Gesinnung
品 (しな): Koketterie, Gefallsucht, (1) Qualität, Güte, (2) Ware, Artikel, Gegenstand, Gut
信頼 (しんらい): Vertrauen, Zutrauen, Verlass, Zuversicht, vertrauen, Vertrauen haben, Vertrauen setzen in …, sich verlassen, Zuversicht setzen in …
従って (したがって): (1) also, daher, darum, demgemäß, demnach, demzufolge, deshalb, deswegen, folglich, infolgedessen, mithin, somit, (2) je … desto, in dem Maße, wie …, in demselben Grad, wie …
署名 (しょめい): Unterschrift, Autogramm, Unterzeichnung, Signatur, Namenszug, unterschreiben, unterzeichnen, seinen Namen darunter setzen, signieren, parafieren
タイプライター: Schreibmaschine
管理 (かんり): (1) Verwaltung, Management, Geschäftsführung, Führung, Leitung, Kontrolle, Aufsicht, (2) Instandhaltung, Bewahrung, (3) Vermögensverwaltung, Treuhandschaft, verwalten, aufpassen
国語 (こくご): (1) Japanisch, japanische Sprache, (2) Landessprache, Muttersprache, (3) eine Sprache
省く (はぶく): (1) weglassen, auslassen, (2) sparen, reduzieren
有り難う (ありがとう): Danke!
言語 (げんご): (1) Sprache, (2) Sprechen, Worte, (3) Langue (im Gegensatz zu Parole bei F. de Saussure), (4) Programmiersprache, Worte, Sprache
冷静 (れいせい): Gemütsruhe, Fassung, Gelassenheit, Kaltblütigkeit, kühl, ruhig, gelassen, beherrscht, gefasst, kaltblütig, leidenschaftslos, teilnahmslos, gleichgültig, in ruhiger Weise, gelassen, beherrscht
担当 (たんとう): Auftrag, Übernahme, Verantwortung, Aufsicht, übernehmen, auf sich nehmen, beaufsichtigen, verantwortlich sein, beauftragt sein
トップ: (1) Spitze, führende Position, (2) Spitzenklasse, Maximum, (3) Front, Anfang, Erster, (4) oberer Teil, höchster Teil, (5) Leitung, Spitzengremium, oberste Exekutive, Topmanagement (einer Organisation), (6) Top-Meldung, Top-Story (einer Zeitung; steht oben rechts), (7) höchster Gang, (8) Kammzug (bandförmiger Strang aus glatten, langen Fasern als Vorbereitung fürs Spinnen)
抱く (いだく): (1) im Herzen tragen, hegen, nähren, pflegen, (2) in die Arme nehmen, (1) in den Armen halten, umarmen, in den Arm nehmen, im Arm tragen, (2) mit jmdm. schlafen, (3) jmdn. zum Freund gewinnen
緊張 (きんちょう): (1) Spannung, Anspannung, Gespanntheit, (2) Spannungen, gespanntes Verhältnis, (3) Tonus, Muskeltonus, (4) Anspannung, sich anspannen, sich anstrengen, sich straffen, wachsam sein, gespannt sein, nervös sein, steif sein, es ernst meinen, auf der Hut sein
影 (かげ): (1) Schatten, (2) Licht, Sonnenlicht, Mondlicht, Sternlicht, (3) Spiegelbild, (4) Gestalt, (5) Umriss, Silhouette, Schattenriss, (6) Gesichtsausdruck, (7) Anzeichen, Vorzeichen, (8) Stellvertreter, Ersatz, (9) Schatten (bei C.G. Jung), (10) Spur, (11) schlanke Form, (12) Seele, Geist
主義 (しゅぎ): (1) Prinzip, Doktrin, Grundsatz, (2) …ismus
平和 (へいわ): Frieden, Ruhe, Stille, friedlich, ruhig, still, friedlich, in Frieden
目的 (もくてき): Zweck, Ziel, Absicht
鋭い (するどい): (1) scharf, spitz, schrill, (2) bissig, scharf, (3) schnell, geschwind, flink, (4) scharfsinnig, empfindsam, (5) Gefühllosigkeit, Kaltherzigkeit
オフィス: Büro
続き (つづき): Fortsetzung, Folge, Aufeinanderfolge, Verlängerung, Zusammenhang
岸 (きし): (1) Ufer, Flussufer, Seeufer, Meeresufer, Meeresküste, Küste, Strand, (2) Steilhang, Klippe, Kishi
差 (さ): Unterschied, Ungleichheit, Differenz, Abstand, Vorsprung, Verschiedenheit, Rest, Bilanz, Mehrheit
筋 (すじ): (1) Muskel, Sehne, Ader, Faser, (2) Linie, Streifen, Strich, (3) Logik, (4) Abstammung, Blut, (5) Vernunft, (6) Handlung (z.b. eines Roman), Plot, (7) Quelle (einer Information)
等しい (ひとしい): (1) gleich, gleichsam, (2) so gut wie, fast
密 (みつ): Dichte, Enge, Präzision, Feinheit, dicht, eng, dick, genau, präzise, vorsichtig, fein
越す (こす): (1) hinübergehen, überschreiten, (2) eine Zeit überschreiten, (3) durchgehen, durchreisen, (4) (einen Standard) überschreiten, übersteigen, (5) überholen, hinter sich lassen, (6) übertreffen, überflügeln, besser sein, stärker sein, (7) glücklich hinwegkommen, glücklich überkommen, überwinden, (8) umziehen, seinen Wohnsitz verlegen, seine Wohnung wechseln, (9) gehen, kommen (ehrerb.-höfl.)
一生 (いっしょう): (1) das ganze Leben, die Lebenszeit, (2) lebenslang, lebenslänglich, das ganze Leben hindurch, lebenslang, lebenslänglich
混乱 (こんらん): (1) Unordnung, Durcheinander, Chaos, Wirrwarr, Konfusion, (2) Verwirrung, Zerstreutheit, in Unordnung geraten
記憶 (きおく): (1) Gedächtnis, Erinnern, (2) Erinnerung, Gedächtnisinhalt, (3) Erinnerung, (4) Speicher, (1) im Gedächtnis haben, unvergesslich bleiben, (2) gedenken, sich erinnern, (3) auswendig lernen, einlernen
発明 (はつめい): Erfindung, erfinden
一瞬 (いっしゅん): (1) ein Blinzeln, (2) Augenblick, Moment, augenblicks, in einem Augenblick
範囲 (はんい): Bereich, Gebiet, Kreis, Wirkungskreis, Sphäre, Umfang, Weite, Grenze, Rand, Umgrenzung
起こる (おこる): (1) entstehen, passieren, sich ereignen, geschehen, sich begeben, erfolgen, stattfinden, vorfallen, vorkommen, sich zutragen, (2) ausbrechen, aufkommen, sich erheben, auftreten, (3) einen befallen, infizieren, krank werden mit …, einen Krankheitsanfall haben, (4) einen befallen, von etw. überwunden werden, führen zu …, resultieren, hervorbringen
ボール: (1) Ball, (2) Wurf, der nicht durch die Schlagzone geworfen wurde und nicht geschlagen wurde, Pappe, Pappkarton, Karton, Schüssel
契約 (けいやく): (1) Vertrag, Kontrakt, (2) Vereinbarung, Abmachung, Versprechen, Abkommen, Konvention, Pakt, Übereinkommen, Übereinkunft, Verabredung, (3) Bund (Adamsbund, Noachbund bzw. Bund des Neuen Testaments), einen Vertrag abschließen, einen Vertrag eingehen, einen Pakt schließen, sich vertraglich verpflichten, sich verabreden, ein Abkommen treffen, vereinbaren
微妙 (びみょう): Feinheit, Eleganz, Zartheit, Zierlichkeit, (1) fein, zart, elegant, zierlich, subtil, (2) delikat, heikel
要素 (ようそ): Element, Faktor, Hauptbestandteil, wesentlicher Bestandteil, wichtiger Umstand, Moment
陽気 (ようき): (1) Jahreszeit, Wetter, (2) Fröhlichkeit, Lustigkeit, Heiterkeit, (3) Lebendigkeit, Munterkeit, lustig, heiter, froh, fröhlich, munter, in lustiger Weise, lustig, heiter
のんびり: (1) sorglos, ungezwungen, (2) gemächlich, behäbig, (3) behaglich, bequem, friedlich, ungezwungen, (1) es sich bequem machen, sich wie zu Hause fühlen, (2) sich entspannen, ausspannen, sich erholen
追う (おう): (1) verfolgen, jagen, (2) vertreiben, verjagen, verscheuchen, (3) absetzen, (4) ausweisen, ausstoßen, (5) treiben, (6) folgen, nachgehen, (7) geschäftig sein, (8) nacheinander geschehen
下 (げ): (1) Unterster, Letzter, Minderwertigkeit, (2) zweiter Band (von zwei Bänden), dritter Band (von drei Bänden)
日曜 (にちよう): Sonntag
手品 (てじな): Zauberei, Zauberkunststück, Taschenspielertrick, Kniff
上達 (じょうたつ): (1) Fortschritt, Vorwärtskommen, Weiterkommen, Verbesserung, (2) Meisterschaft, Können, Geübtheit, (3) Übermittlung (an eine höhergestellte Person), (1) Fortschritte machen, vorwärtskommen, sich verbessern, besser werden, geübter werden, (2) meistern, vervollkommnen
下 (しも): (1) unterer Teil, Fuß, (2) Unterlauf eines Flusses, (3) hinterer Teil eines Ausdruckes, (4) unterer Teil einer Serie, (5) Vasallen und Volk, (6) Arbeitnehmer, Beschäftigter, (7) unten gelegener Ort, (8) Körper hüftabwärts (und was damit zu tun hat), (9) Exkremente, (10) zweiter Teil
離れる (はなれる): (1) sich befreien, (2) sich abtrennen, sich absondern, sich entfernen, sich scheiden, entfernt sein, abkommen, losfahren, loslösen, (3) verlassen, sich trennen, auseinandergehen
包み (つつみ): Pack, Packen, Päckchen, Paket
語学 (ごがく): (1) Sprachwissenschaft, Linguistik, (2) Fremdsprachenstudium, (3) Fremdsprache, Sprache (als Fach)
奥 (おく): Oku, (1) Inneres, das Innere, die Tiefe, (2) hinter Teil, (3) Tiefe eines Gebäudes, (4) (ehrende Bez. f.) Ehefrau einer hochrangigen Person, (5) Gemahlin, Frau, (6) entfernter Teil, das Tiefe, (7) Kern, Wesen, (8) hinterer Teil (eines Briefes oder Buches), (9) Zukunft, kommende Zeit, (10) von der Hauptstadt entfernter Ort
王 (おう): (1) Herrscher, Monarch, König, Königin, Kaiser, Kaiserin, (2) König (der Tiere, eines Sports etc.), (3) König, (4) nicht als Prinz proklamierter Sohn des Kaisers
後 (のち): (1) spätere Zeit, (2) nach, danach, später, (3) Zukunft, (4) in der Zukunft, zukünftig, (1) später, folgend, (2) zukünftig
貴重 (きちょう): (1) Kostbarkeit, Hochwertigkeit, Unschätzbarkeit, (2) Wichtigkeit, wertvoll, kostbar, hochwertig, unschätzbar, unersetzlich
隠れる (かくれる): (1) verschwinden, (2) sich verstecken, sich verbergen, sich zurückziehen, (3) sich aus der Welt zurückziehen, (4) unbekannt sein, verborgen sein, (5) sterben, (6) beschützt werden, behütet sein
逆 (ぎゃく): (1) Gegenteil, Umkehrung, Rückseite, (2) Konversion, (3) Umkehr, Wendung, (4) Handlung gegen die normale Richtung, (1) umgekehrt, entgegengesetzt, verkehrt, gegenteilig, gegensätzlich, gegenüberliegend, widersprechend, (2) reziprok
父親 (ちちおや): Vater
拍手 (はくしゅ): Beifallsklatschen, Applaus, klatschen, Beifall klatschen, Beifall spenden, applaudieren
援助 (えんじょ): Hilfe, Unterstützung, Beistand, Hilfeleistung, unterstützen, beistehen, behilflich sein, mitwirken
広がる (ひろがる): (1) sich ausweiten, weit werden, breit werden, sich ausdehnen, (2) sich ausbreiten, sich verbreiten, (3) sich vergrößern, zunehmen, (4) sich entwickeln, sich entfalten
症状 (しょうじょう): Symptom, Krankheitszeichen, Krankheitszustand
ドライブ: (1) Fahrt, Spazierfahrt, Autofahrt, (2) Laufwerk, Auto fahren, eine Spazierfahrt machen
活気 (かっき): Leben, Lebhaftigkeit, Lebendigkeit, Lebenskraft, Lebensgeister
何故なら (なぜなら): weil, denn, da, der Grund dafür ist, dass …
関する (かんする): angehen, sich beziehen auf …, betreffen, anbelangen
収入 (しゅうにゅう): Einkommen, Einkünfte, Einnahme
商売 (しょうばい): (1) Handel, Geschäft, (2) Gewerbe, Beschäftigung, Beruf, Handel treiben, Handel betreiben, ein Geschäft betreiben, ein Gewerbe betreiben
食物 (しょくもつ): Essen, Speise, Nahrung
実は (じつは): wirklich, ehrlich, eigentlich, tatsächlich
知識 (ちしき): (1) Kenntnis, Wissen, Gelehrsamkeit, (2) Gelehrter, Weiser
人気 (にんき): (1) Beliebtheit, Popularität, (2) Volksstimmung, Charakter eines Volkes, (3) Geschäftslage
患者 (かんじゃ): Patient, Kranker, Opfer (einer Krankheit), Krankheitsfall, Fall
達する (たっする): (1) erreichen, erlangen, (2) ankündigen, bekannt machen, (3) ankommen, gelangen, (4) sich erstrecken, betragen
汗 (あせ): (1) Schweiß, Schwitzen, (2) Kondenswasser, Schwitzwasser, (3) Blut (als Tabu-Ersatzwort in der Geheimsprache der Hofdamen)
生物 (せいぶつ): (1) Lebewesen, Organismus, Geschöpf, (2) Biologie
話し合う (はなしあう): besprechen, sich unterhalten über, ein Gespräch führen über
寧ろ (むしろ): vielmehr, oder besser, richtiger, lieber (als), besser, eher
終える (おえる):  (Studium, Schule) abschließen, beenden, graduieren, beenden, abschließen, vollenden, erledigen, fertig stellen, zu Ende bringen
要点 (ようてん): Hauptpunkt, wichtiger Punkt
及ぼす (およぼす): (1) erreichen lassen, ausdehnen, ausweiten, ausüben, (2) es zu etw. kommen lassen
決定 (けってい): (1) Entscheidung, Beschluss, Bestimmung, Festsetzung, Entschließung, (2) gerichtlicher Beschluss, (3) Determination (Differenzierung zunächst undifferenzierter Zellen), entscheiden, bestimmen, festlegen, beschließen, eine Entscheidung treffen, einen Beschluss fassen, zu einer Entscheidung kommen
譲る (ゆずる): (1) abtreten, überlassen, übertragen, übereignen, schenken, übergeben, verkaufen, veräußern, (2) einräumen, zugestehen, (3) nachgeben, weichen, (4) aufschieben
障害 (しょうがい): Störung, Hindernis, Hürde, (1) Hindernis, Verhinderung, (2) Störung, (3) Läsion, Funktionsstörung, Beeinträchtigung, Beschwerden, Leiden, (4) Geistesstörung
如何しても (どうしても): (1) auf keinen Fall, gar nicht, (2) koste es, was es wolle, unbedingt
正午 (しょうご): Mittag, zu Mittag, am Mittag, mittags
がっかり: (1) enttäuscht, entmutigt, (2) erschöpft, entkräftigt, (1) enttäuscht sein, entmutigt sein, niedergeschlagen sein, (2) völlig müde sein, völlig erschöpft sein, fertig sein, abgearbeitet sein, zerschlagen sein
渋滞 (じゅうたい): Stockung, Verzögerung, Stauung, stocken, sich verzögern, sich stauen
身 (み): (1) Körper, Person, (2) man selbst, (3) Fleisch, Fischfleisch, (4) jmds. sozialer Status, (5) Behälter, Schale, Topf, (6) Schwertklinge
願う (ねがう): (1) beten, bitten (einen Gott oder Buddha), (2) fragen, bitten, (3) wünschen, hoffen, (4) ein Gesuch einreichen (bei einer Behörde), (5) (in der Form o・negai suru) …, bitte, geben Sie mir bitte …, holen Sie mir bitte …, (6) (in der Form o・negai suru nach Renyō・kei) tun Sie bitte …, machen Sie bitte, …
知恵 (ちえ): (1) Weisheit, Vernunft, Einsicht, Intelligenz, Klugheit, Gescheitheit, Verstand, (2) Findigkeit, (3) Ratschlag, nützliche Worte
尚 (なお): (1) mehr, weniger, (2) noch mehr, noch weniger, (3) immer noch
頂上 (ちょうじょう): (1) Gipfel, höchste Erhebung, Pik, Spitze, (2) Zenit, Gipfelpunkt, Höhepunkt, Akme, (3) Person im jöchsten Rang, (4) Scheitel, (5) Auftürmen, Stapeln
象 (ぞう): Elefant
検討 (けんとう): Untersuchung, Prüfung, Überprüfung, Musterung, Nachforschung, Durchsicht, überprüfen, nachprüfen, durchsehen, untersuchen
救う (すくう): (1) retten, helfen, unterstützen, (2) in Ordnung bringen, (3) zu geistiger Stabilität oder zur Erleuchtung führen, befreien, erlösen
既に (すでに): (1) zuvor, vorher, früher, längst, (2) schon, bereits, (3) nicht mehr (bei Verneinung), (4) vollständig, insgesamt, ohne Ausnahme, (5) fast, beinahe, (6) offensichtlich, unbestreitbar, zweifellos
沖 (おき): (1) hohe See, offenes Meer, (2) abgelegenes Feld
積もる (つもる): (1) sich anhäufen, sich ansammeln, liegen, (2) sich aufstauen, (3) betragen, abschätzen
可能 (かのう): Möglichkeit, möglich
破産 (はさん): Bankrott, Konkurs, Bankrott machen, in Konkurs geraten, bankrottgehen
屡々 (しばしば): oft, öfters, häufig, mehrmals, wiederholt
印 (しるし): (1) Zeichen, Symbol, (2) Kennzeichen, Merkmal, (3) Wappen, (4) Abzeichen, (5) Signal, Wink, (6) Beweis, Beweismittel, (7) (jurist.)Beweis, (8) Kerbzettel, Kerbholz, zerbrochener oder auseinander gerissener Echtheitsbeweis, (9) abgeschlagener Kopf eines Feindes, (10) Siegelband, (11) kaiserliches Siegel, (12) Anzeichen, Vorzeichen, (13) Ahnung, (14) Wunderzeichen, (15) Wirkung, (16) Vergeltung
非常 (ひじょう): Notfall, Ausnahmefall, Katastrophe, Unfall, Unglück, außergewöhnlich, außerordentlich, äußerst, enorm, sehr, erheblich, ungemein, gewaltig
文字 (もじ): Schriftzeichen, Buchstabe, Schrift
服装 (ふくそう): Kleidung
味方 (みかた): Freund, Beistand, Anhänger, Verbündeter, Person auf unserer Seite, helfen, zur Seite stehen, beistehen, Partei ergreifen für
活動 (かつどう): (1) Tätigkeit, Wirksamkeit, Aktivität, Auswirkung, (2) Film, bewegte Bilder (veraltet), tätig sein, beschäftigt sein, wirken, sich betätigen, funktionieren, in Tätigkeit sein
活用 (かつよう): (1) Nutzanwendung, Anwendung, Verwendung, Gebrauch, Verwertung, Auswertung, (2) Flexion, Beugung, Deklination, Konjugation, (1) praktisch gebrauchen, nützlich verwenden, verwerten, (2) flektieren, deklinieren, konjugieren
優れる (すぐれる): (1) übertreffen, den Rang ablaufen, überbieten, überflügeln, überlegen sein, hervorragend sein, (2) sich wohl fühlen
羽 (はね): (1) Flügel, (2) Feder, (3) Gefieder, Federkleid, (4) Federn am Schaftende eines Pfeils, Gefieder, (5) Flügelchen an Samenkapseln verschiedener Pflanzen, (6) Rotorblatt, Ventilatorblatt, Turbinenblatt, (7) Federwappen, Wappen mit Federmuster
失う (うしなう): (1) verlieren, einbüßen, nicht mehr finden, um etw. kommen, verloren gehen, abhanden kommen, verlegen, (2) vermissen, fehlen
角 (つの): (1) Horn (bei Rind, Ziege, Nashorn etc.), Geweih (bei Rotwild), (2) Fühler (z.B. einer Schnecke), (3) Eifersucht, Wut, (4) ein Familienwappen
笑い (わらい): Lachen, Gelächter, Lächeln
トラック: (1) Bahn, Laufbahn, (2) Stück, Track, Lastwagen, Laster, LKW
共に (ともに): (1) mit, zusammen mit, beide, (2) sowohl … als auch …, beide, (3) zugleich, während
嗽 (うがい): Gurgeln
運 (うん): (1) Schicksal, Geschick, Los, Vorbestimmung, Fatum, (2) Glück, glückliches Schicksal
入場 (にゅうじょう): Eintritt, Zutritt, Einlass, Einzug, Einmarsch, eintreten
スケート: (1) Schlittschuhlaufen, Schlittschuh, (2) Rollschuh, Rollschuhlaufen (Abk.), (3) Roller, Tretroller
跡 (あと): (1) Fußabdruck, Fußstapfen, Fußspur, Fährte, (2) Spur, Gleis, (3) Reste, Überbleibsel, Ruine, (4) Vorbild, Muster, Präzedenzfall, (5) Hinterlassenschaft, Vermächtnis, Erbe, (6) Hinterbliebener, (7) (übertr.), (8) Ort, an dem sich die Füße befinden, (9) zu Füßen, (10) Schrift, Handschrift, Schriftzeichen
感情 (かんじょう): (1) Gefühl, Empfindung, Gemüt, Leidenschaft, Empfindsamkeit, (2) Emotion
相当 (そうとう): (1) (2) (3) , entsprechen, angemessen sein, geeignet sein, passen, gleichwertig sein, (1) passend, angemessen, geeignet, (2) ansehnlich, beträchtlich, ordentlich, tüchtig, recht, beträchtlich, ziemlich
瓶 (びん): (1) Flasche, (2) Vitrum, Arzneiflasche, (3) (Zählwort für)Flaschen
も: (1) auch, ebenso, und auch, nicht nur …, sondern auch …, sowie, sowohl … als auch …, (2) auch, schon selbst, sogar, (3) (mit Verneinung) weder … noch …, (4) wenn auch, auch wenn
穏やか (おだやか): (1) friedlich, ruhig, mild, mäßig, sanft, (2) ruhig, ausgeglichen, (3) ruhig, mit ruhiger Stimme, mit ruhigen Bewegungen, Stille, Ruhe, Friedfertigkeit, still, ruhig, friedlich, friedfertig, mäßig, mild, in ruhiger Weise, still, friedlich, mäßig
成績 (せいせき): (1) Leistung, Erfolg, Resultat, Ergebnis, (2) Zensur, Note
典型 (てんけい): Modell, Mustertyp, Vorbild
先日 (せんじつ): neulich, vor Kurzem, dieser Tage, jüngst, kürzlich, letzthin, unlängst
際 (さい): wenn, falls, als
不可 (ふか): (1) Ungenügen, Unrichtigkeit, Schlechtigkeit, (2) Ungenügend, Sechs, (3) unrichtig, falsch, schlecht, ungehörig, (4) unmöglich, (5) ungenügend
好み (このみ): Geschmack, Vorliebe, Neigung, Hang
解ける (とける): (1) sich lösen, sich lockern, (2) gelöst werden, (3) schmelzen, (4) aufgehoben werden
請求 (せいきゅう): Bitte, Gesuch, Forderung, Antrag, Eingabe, Rechnung, verlangen, fordern, einfordern, berechnen, in Rechnung stellen
肌 (はだ): Haut, (1) Haut, (2) Oberfläche, (3) Charakter, Gemütsart, Temperament, Neigung
ミス: Fehler, Fräulein, einen Fehler machen
何れ (いずれ): (1) welcher, (2) jede, alle, (3) irgendwie, auf alle Fälle, jedenfalls, (4) bald, in Kürze, früher oder später
上 (じょう): (1) ausgezeichnet, best, feinst, erst, vorangegangen, alt, (2) erster Band
状況 (じょうきょう): Stand der Dinge, Sachlage, Situation, Umstände, Verhältnisse
舌 (した): (1) Zunge, (2) Klöppel, (3) Rohrblatt
バン: Van, Kleintransporter, Lieferwagen
友人 (ゆうじん): Freund, Bekannter
玉 (たま): Kugel, Gewehrkugel, Geschoss, (1) Kugel, Ball, (2) Tropfen, Träne, (3) Ball (bei Baseb., Golf, Billard etc.), (4) Wurf, (5) Kugel, Gewehrkugel, Kanonenkugel, Geschoss, (6) Glühbirne, Birne, (7) Linse, Glas (einer Brille), (8) Kugel eines Soroban, (9) Eier, Hode, Hoden, Testikel, (10) (runder)Juwel, Edelstein, Perle, (11) Nudelnest, (12) schöne Frau, (13) Schönheit einer Frau, (14) Geisha, (15) Prostituierte, (16) Person, Mensch (insbes., wenn es ums Aussehen geht), (17) zur Verwirklichung eines Planes notwendige Personen oder Finanzen
感じる (かんじる): (1) fühlen, empfinden, wahrnehmen, spüren, merken, ahnen, den Eindruck haben, (2) bewegt sein, gerührt sein, beeindruckt sein
博物館 (はくぶつかん): Museum
注ぐ (そそぐ): (1) gießen, eingießen, (2) fließen, (3) bewässern, berieseln, (4) einfließen, münden, (5) sich widmen, sich hingeben, sich vertiefen
読書 (どくしょ): Lesen, Lektüre, lesen
チャンス: Chance, Möglichkeit, Gelegenheit
我々 (われわれ): wir, unsereins, uns, unser
家事 (かじ): (1) Haushalt, Hausarbeit, Haushaltung, häusliche Geschäfte, (2) häusliche Angelegenheiten, Familienangelegenheiten
就職 (しゅうしょく): Finden einer Anstellung, Bekommen einer Arbeit, Amtsantritt, Dienstantritt, eine Stellung finden, eine Anstellung finden, eine Arbeitsstelle finden
幸運 (こううん): Glück, glückliches Schicksal, glücklicher Zufall, glücklich
虫歯 (むしば): fauler Zahn, schlechter Zahn, schlechter Zahn, kariöser Zahn, Zahnfäule, Karies
道徳 (どうとく): Moral, Sittlichkeit, Ethik, Tugend, (1) moralisch, sittlich, (2) tugendhaft
信号 (しんごう): (1) Signal, Zeichen, (2) Ampel, Signalanlage, ein Signal geben, signalisieren
認める (みとめる): (1) merken, bemerken, erblicken, erkennen, feststellen, zugeben, (2) anerkennen, genehmigen, billigen, (3) zugeben, einräumen, (4) erklären für
欧羅巴 (ヨーロッパ): Europa
合わせる (あわせる): (1) vereinen, verbinden, verknüpfen, zusammenfügen, annektieren, vereinigen, (2) auflegen, aufsetzen, falten, (3) hinzufügen, addieren, (4) einstellen, aufeinander abstimmen, stimmen, richtig einstellen, (5) vergleichen, gegeneinander halten, (6) anpassen, verbinden
ヨット: Jacht, Yacht, Segelboot
完全 (かんぜん): Vollkommenheit, Vollständigkeit, Vollendetheit, Intaktheit, vollkommen, vollendet, vollständig, vollkommen, vollständig, perfekt
癖 (くせ): (1) Gepflogenheit, Gewohnheit, (2) Angewohnheit, Hang, Sucht, Laster, Schwäche, (3) Eigenheit, Eigenart, Eigentümlichkeit, Marotte, (4) Kräuselung (von Haar)
場面 (ばめん): (1) Schauplatz, Stelle, Ort, Situation, (2) Szene, Auftritt
同様 (どうよう): gleich, identisch, ebenso, ähnlich, desgleichen, gleich, gleichartig, derselbe, identisch, so gut wie
巻 (かん): Band, Buch
詰まり (つまり): (1) Füllung, Verstopfung, (2) Ende, (3) nämlich, kurzum, kurz gesagt, mit anderen Worten, (4) letzten Endes, langfristig gesehen
紐 (ひも): (1) Schnur, Kordel, Faden, Band, Strick, (2) Bedingung, Beschränkung, (3) Zuhälter, Gigolo, Liebhaber, der sich aushalten lässt, (4) Mantel, Pallium (bei Mollusken)
黒板 (こくばん): Tafel, Schreibtafel, Schultafel, Wandtafel
腰 (こし): Hüfte, Kreuz, Taille, Lende, Leib
成長 (せいちょう): (1) Wachsen, Wachstum, Entwicklung, Wuchs, (2) Erwachsenwerden, Großwerden, Heranwachsen, Aufwachsen, Adoleszieren, (1) wachsen, sich entwickeln, (2) erwachsen werden, groß werden, heranwachsen, aufwachsen, adoleszieren
酔う (よう): (1) betrunken werden, sich betrinken, berauscht sein, (2) sich schlecht fühlen, es ist einem schlecht, es ist einem übel, (3) sich an etw. berauschen
給料 (きゅうりょう): (1) Lohn, Gehalt, Bezüge, Sold, (2) Studiengeld (das ein Teil der Studenten in der Heian-Zeit ausgezahlt bekam)
益々 (ますます): mehr und mehr, immer mehr, immer …er (z.B. kälter)
議員 (ぎいん): Abgeordneter, Parlamentarier, Volksvertreter
姿 (すがた): (1) Gestalt, Form, Statur, Figur, Körperhaltung, Erscheinung, Pose, Positur, Aussehen, (2) Kleidung, (3) Aufmachung, (4) Aspekt, Zustand
積極的 (せっきょくてき): positiv, aktiv, energisch, aktiv, positiv, in energischer Weise, in aktiver Weise
国会 (こっかい): Parlament, Kongress, Volksvertretung, Bundestag
通行 (つうこう): Verkehr, Durchgang, Durchgehen, Durchfahrt, Durchfahren, fahren, verkehren, gehen, passieren, durchfahren
組織 (そしき): (1) Organisation, Formation, (2) Struktur, Gefüge, Gliederung, Konstruktion, Zusammensetzung, (3) Gewebe, (4) System, (1) formen, organisieren, konstruieren, zusammensetzen, etw. bilden, (2) systematisieren, in ein System bringen, systematisch behandeln, gliedern
苦手 (にがて): (1) gefährlicher Gegner, harte Nuss, jmd., mit dem schwer umzugehen ist, (2) Schwäche, Schwachpunkt, schwache Seite, Achillesferse, (1) schwach, unbegabt, unfähig, (2) schwierig, wenig umgänglich
命 (いのち): (1) Leben, Lebenskraft, (2) Lebensspanne, (3) Allerwichtigste, (4) Tattoo auf dem Oberarm als Zeichen der Liebe
変更 (へんこう): Änderung, Veränderung, Abänderung, ändern, verändern, abändern
出会い (であい): Begegnung, Treffen
改善 (かいぜん): (1) Verbesserung, Richtigstellung, Änderung zum Vorteil, Reform, (2) Kaizen, kontinuierlicher Verbesserungsprozess (mit Kaizen wird im Westen ein angeblich aus Japan stammendes Unternehmensführungskonzept, das auf einer Philosophie der ständigen Veränderung beruht, bezeichnet; insbes. Toyota ist für Kaizen berühmt; in dieser Bedeutung mitunter in Katakana geschrieben, um nicht mit der normalen Bedeutung verwechselt zu werden), verbessern
体温 (たいおん): Körpertemperatur
親友 (しんゆう): enger Freund, guter Freund, vertrauter Freund
損 (そん): Verlust, Schaden, Nachteil, Einbuße, (1) verlustbringend, unrentable, nicht Gewinn bringend, (2) schädlich, ungünstig, nachteilig
握る (にぎる): (1) greifen, ergreifen, fassen, erfassen, ballen, (2) halten, bewahren, (3) ergreifen, in Besitz nehmen, bekommen, (4) Nigiri・zushi machen, O・nigiri machen
議長 (ぎちょう): Vorsitzender, Präsident, Sprecher (einer Versammlung)
旗 (はた): (1) Flagge, Fahne, (2) Fahnenabzeichen, (3) Familienwappen, (4) Werkzeug, das die Erhabenheit eines Buddhas oder Bodhisattvas zeigt (sanskr. patākā)
他人 (たにん): (1) anderer, Fremder, andere Leute, fremde Leute, (2) nicht verwandte Person
考え (かんがえ): (1) Gedanke, Denken, Nachdenken, Vorstellung, (2) Überlegen, Überlegung, Einfall, (3) Gedanke, Erwägung, (4) Gedanke, Idee, Begriff, (5) Meinung, Ansicht, Auffassung, (6) Urteil, Erachten, (7) Absicht
今後 (こんご): von jetzt an, von nun an, künftig, in Zukunft
被害 (ひがい): (1) Schadennehmen, Erleiden eines Schadens, Schädigung, Geschädigtwerden, (2) erlittener Schaden
剃る (そる): rasieren, sich rasieren, scheren
愛する (あいする): jmdn. lieben, jmdn. gern haben, jmdm. geneigt sein, an jmdm. Gefallen finden
何か (なにか): (1) irgendetwas, (2) nichts (mit Verneinung)
即ち (すなわち): nämlich, das heißt, das ist, mit anderen Worten
品 (ひん): (1) Würde, Vornehmheit, Feinheit, (2) Ware, Artikel, Erzeugnis
暖かい (あたたかい): (1) warm, mild, (2) warmherzig, freundlich, herzlich, (1) warm, mild, (2) finanziell gut versorgt, (3) warmherzig, freundlich, herzlich 
交際 (こうさい): Umgang, Bekanntschaft, Bekanntenkreis, Gesellschaft, Freundschaft, Beziehung, Verkehr, Umgang pflegen, Umgang haben, verkehren
氷 (こおり): (1) Eis, (2) Splittereis, (3) Eiswürfel, (4) geraspeltes Eis mit Sirup
思わず (おもわず): ohne es zu wollen, unwillkürlich, instinktiv, unbewusst, unabsichtlich
著者 (ちょしゃ): Verfasser, Autor
グループ: Gruppe
瞬間 (しゅんかん): Augenblick, Moment, in einem Augenblick, im Nu
息 (いき): (1) Atem, Atemzug, Atmen, Atmung, Hauch, Odem, (2) Ton, Stimmung
祝う (いわう): feiern, gratulieren, beglückwünschen, ein Fest begehen
修正 (しゅうせい): Verbesserung, Nachbesserung, Revision, Korrektur, Berichtigung, verbessern, nachbessern, revidieren, korrigieren
湖 (こ): See
感 (かん): (1) Empfindung, Eindruck, Sinn, (2) Gefühl, Rührung, Bewunderung, (3) …‑Gefühl
申し込む (もうしこむ): (1) beantragen, anmelden, bestellen, vorschlagen, anbieten, (2) sich bewerben, (3) reservieren, buchen
順番 (じゅんばん): Reihenfolge, Reihe
ばったり: (1) plötzlich, unvermutet, auf einmal, (2) zufällig, unerwartet, (3) plumsend, mit einem Plumps
強盗 (ごうとう): (1) Raub, Raubüberfall, räuberischer Diebstahl, (2) Räuber
物語 (ものがたり): (1) Geschichte, Erzählung, Schilderung, (2) Legende, Märchen, Sage, Fabel, Roman, Fiction, erzählende Literatur, Episode
ブレーキ: Bremse, Radschuh
許可 (きょか): (1) Erlaubnis, Genehmigung, Bewilligung, Einwilligung, Autorisierung, (2) Lizenz, Konzession, (3) Patent, erlauben, genehmigen
論じる (ろんじる): (1) argumentieren, einen Beweis führen, diskutieren, erörtern, debattieren, disputieren, (2) sich mit etw. befassen, sich mit etwas beschäftigen, behandeln, gehen um …, (3) thematisieren, zum Thema machen
訳 (やく): Übersetzung
育つ (そだつ): (1) aufwachsen, wachsen, heranwachsen, (2) groß werden, (3) erwachsen werden, (4) aufziehen, großziehen, (5) erziehen, ausbilden
お昼 (おひる): Mittagessen
クラシック: (1) Klassik, (2) Klassik, klassische Musik, klassisch
弁当 (べんとう): Bentō, O-Bentō, Imbiss zum Mitnehmen, Lunchpaket, Verpflegungspaket, mitgebrachtes Essen
秘密 (ひみつ): Geheimnis, vertraulich, im geheimen, geheim, verborgen, heimlich, vertraulich, geheimnisvoll, mystisch, mysteriös
事実 (じじつ): (1) Tatsache, Tatbestand, Faktum, Wirklichkeit, Gegebenheit, Realität, (2) wirklich, tatsächlich, in der Tat
繋ぐ (つなぐ): (1) anbinden, (2) anleinen, anketten, (3) festmachen, (4) vertäuen, (5) verbinden, verknüpfen, (6) anschließen (Elektrogerät), (7) verbinden, eine Verbindung herstellen, (8) erhalten, bewahren, wahren, (9) (einer Spur) folgen
光景 (こうけい): Szene, Anblick
退屈 (たいくつ): Langeweile, Langweiligkeit, (mn) Ennui, sich langweilen, sich ennuyieren, langweilig, fad, eintönig, uninteressant, ennuyant
当時 (とうじ): zu jener Zeit, damals
成功 (せいこう): Erfolg, Gelingen, Glück, Erfolg haben, gelingen, von Erfolg gekrönt sein, glücken, klappen
金曜 (きんよう): Freitag
意識 (いしき): (1) Wahrnehmung, Empfindung, (2) Bewusstsein, Selbstbewusstsein, Besinnung, (3) Bewusstwerden, Klarwerden, (4) Bewusstsein, (5) gesellschaftliches Bewusstsein, (6) Selbstbewusstsein, (7) Erkenntnisbewusstsein (Sanskr. mano-vijñāna), bewusst sein, bewusst werden, wahrnehmen, gewahr werden
願い (ねがい): (1) Bitte, Wunsch, Hoffnung, (2) Bewerbung, Antrag
効く (きく): (1) wirksam sein, wirken, Wirkung zeigen, (2) funktionieren, (3) möglich sein, (4) Sake kosten und beurteilen
航空 (こうくう): Luftfahrt, Fliegen, Luftfahrtwesen, Flugwesen
通学 (つうがく): Schulbesuch, zur Schule gehen, zur Schule fahren
埃 (ほこり): (1) Staub, (2) Leichen im Keller, etw. Schlechtes
結論 (けつろん): (1) Schluss, Schlussfolgerung, Folgerung, Konsequenz, (2) Schlussfolgerung, Konklusion, schließen, zu einem Schluss kommen
同時 (どうじ): gleiche Zeit, (1) gleichzeitig, zur selben Zeit, simultan, synchron, synchronistisch, (2) während
供給 (きょうきゅう): (1) Versorgung, Lieferung, Belieferung, (2) Angebot (engl. supply), versorgen, liefern, beliefern, verschaffen
我が儘 (わがまま): Eigensinn, Eigenwille, Eigennutz, Selbstsucht, Egoismus, Willkür, eigensinnig, eigenwillig, selbstsüchtig, egoistisch, willkürlich, launisch
沈む (しずむ): (1) untergehen, versinken, (2) sinken, sich senken, (3) niedergeschlagen sein, mutlos werden, schwermütig werden
助手 (じょしゅ): (1) Assistent, Mitarbeiter, Gehilfe, Helfer, (2) Universitätsassistent, (3) Beifahrer
スタイル: (1) Figur, (2) Stil, Mode, (3) Schreibstil, Stil
種 (たね): (1) Samen, Kern, Stein, Saat, (2) Ursache, Grund, Quelle, (3) Thema, Gegenstand, (4) Art, Sorte, (5) Geheimnis, Trick, (6) väterliche Blutsverwandschaft, väterliche Abstammung (in dieser Bed. auch 胤 geschrieben)
徹底 (てってい): Gründlichkeit, auf den Grund gehen, durchdringen
悲劇 (ひげき): Trauerspiel, Tragödie
上等 (じょうとう): hervorragende Qualität, Erstklassigkeit, Auserlesenheit, Vorzüglichkeit, erstklassig, vorzüglich, von guter Qualität, auserlesen, gediegen, tadellos
助ける (たすける): (1) helfen, retten, (2) unterstützen, beistehen, erlösen, (3) beitragen
翼 (つばさ): (1) Flügel (eines Vogels), (2) Tragfläche (eines Flugzeuges), (3) Flanke, Flügel, Flügel
遂に (ついに): am Ende, zum Schluss, schließlich, zuletzt, endlich
軍隊 (ぐんたい): Armee, Heer, Truppe, Korps
現れる (あらわれる): (1) auftauchen, erscheinen, auftreten, herauskommen, sich zeigen, zum Vorschein kommen, (2) sichtbar werden, zu sehen sein, auftauchen, (3) entdeckt werden, entlarvt werden, (4) berühmt werden, sich einen Ruf erwerben
発車 (はっしゃ): Abfahrt, abfahren, sich in Bewegung setzen
はあ: Joshi wa (Partikel zur Markierung des Satzthemas), wie bitte?, (1) ja, in der Tat, (2) wie bitte?, Entschuldigung?
婚約 (こんやく): Verlobung, Verlöbnis, sich verloben, ein Verlöbnis eingehen
無料 (むりょう): Kostenlosigkeit, Gebührenfreiheit, umsonst, kostenlos, gratis, gebührenfrei, ohne Bezahlung, unentgeltlich, frei
量 (りょう): Menge, Quantität, Volumen, Quantum
本人 (ほんにん): der Betreffende, die in Frage kommende Person, jmd. selbst, jmd. in eigener Person
問い (とい): Frage, Problem
現実 (げんじつ): Wirklichkeit, Gegebenheit, Realität, Aktualität, Sinnenwelt, Welt der Dinge
油 (あぶら): (1) Öl (nicht mit Wasser lösliche leicht brennbare Flüssigkeit), (2) (pflanzliches)Fett, (3) Fett, das bei Zimmertemperatur flüssig ist, (4) glänzend-glatte Oberfläche
大気 (たいき): (1) Größe, Großmut, Großherzigkeit, (2) Luft, (3) Atmosphäre, Lufthülle der Erde
鬼 (おに): (1) Teufel, Dämon, Satan, (2) böser Geist, (3) Seele eines Verstorbenen, (4) Fangermandl, Fänger beim Spielen, (5) Teufels…, unnachgiebiger, gnadenloser
物価 (ぶっか): Preis, Warenpreis
収める (おさめる): (1) einnehmen, annehmen, erwerben, gewinnen, (2) bezahlen, zahlen, (3) schenken, spenden, stiften, (4) abliefern, liefern, (5) beenden, (1) zahlen, bezahlen, (2) liefern, (3) schenken, spenden, stiften, weihen, (4) hineintun, (5) beenden, (6) annehmen, aufbewahren
学期 (がっき): Abschnitt des Studienjahres, Semester (bei zwei Abschnitten pro Jahr), Trimester (bei drei), Quartal (bei vier)
外出 (がいしゅつ): Ausgehen, Ausgang, Verlassen des Hauses, ausgehen, das Haus verlassen, weggehen
賞 (しょう): Preis, Belohnung, Lohn
納得 (なっとく): Verständnis, Zustimmung, Einwilligung, Billigung, Einverständnis, verstehen, einsehen, zustimmen, sich zufriedengeben, sich zusammenreimen, sich überzeugen,  (landsch.) löffeln, kleinkriegen
ゲーム: Spiel, Satz
機関 (きかん): (1) Motor, Maschine, Dampfmaschine, (2) Organ, Einrichtung, (3) Organ, Institution, System, (4) Mechanismus, Maschinerie, Vorrichtung
周囲 (しゅうい): Umkreis, Umfang, Peripherie, Umgebung, Umwelt, rundum, ringsumher, rings, auf allen Seiten, umgebend, benachbart
防ぐ (ふせぐ): (1) verteidigen, abwehren, schützen vor, (2) verhüten, vorbeugen, (3) widerstehen, sich widersetzen, (4) abhalten, verhindern, hemmen
メンバー: Mitglied, Aufstellung
そっと: (1) leise, sacht, still, leicht, ruhig, sanft, (2) heimlich, geheim, unauffällig
教科書 (きょうかしょ): Schulbuch, Lehrbuch
予期 (よき): Erwartung, Erwarten, Voraussicht, Antizipieren, Hoffen, erwarten, rechnen mit, voraussehen
進める (すすめる): (1) vorwärts bewegen, vorrücken lassen, (2) fördern, vorantreiben, Vorschub leisten, helfen, (3) beschleunigen
大会 (たいかい): (1) (große)Versammlung, Generalversammlung, Hauptversammlung, Konferenz, Kongress, Parteitag, (2) Turnier, Sportfest
文句 (もんく): (1) Worte, Ausdruck, Redensart, Redewendung, Bemerkung, (2) Beschwerde, Widerspruch, Einspruch, Einwand, Klage
何処か (どこか): irgendwo
気に入る (きにいる): gefallen, mögen
欠席 (けっせき): Abwesenheit, Nichterscheinen, Fehlen, Ausbleiben, nicht teilnehmen, abwesend sein, fehlen
有効 (ゆうこう): Gültigkeit, Geltung, Wirkung, Wirksamkeit, Effekt, geltend, gültig, rechtgültig, wirksam, effektiv, wirkungsvoll
支払い (しはらい): Zahlung, Bezahlung
進学 (しんがく): Wechsel auf eine höhere Schule, auf einer höheren Schule aufgenommen werden
居間 (いま): Wohnzimmer, Wohnstube
故郷 (ふるさと): Geburtsort, Heimat, Heimat, Geburtsort, Gebiet, in dem man geboren und aufgewachsen ist, Geburtsort, Heimat
哀れ (あわれ): (1) Trauer, (2) Elend, (3) Mitleid, Erbarmen, Mitgefühl, (4) Rührung, Gefühl, (5) ach! (Ausruf vor Rührung über etw.), (1) Trauer, (2) Elend, (3) Mitleid, Erbarmen, Mitfühlen, arm, armselig, dürftig, elend, bedauernswert, herzzerreißend, jämmerlich, kläglich, mitleiderregend, mitleidig, rührend, traurig
袋 (ふくろ): (1) Sack, Beutel, Tasche, Tüte, (2) Beutel (eines Beuteltieres), (3) Segment (einer Zitrusfrucht), Spalte, Schnitzen, (4) Sackgasse, Sackstraße, (5) von Wasser umgebenes Gebiet, (6) Geldbeutel
更に (さらに): (1) ferner, weiterhin, des weiteren, außerdem, überdies, dazu, noch, oben drein, noch mehr, immer mehr, (2) wieder, noch einmal, wiederum, abermals, von neuem, (3) (mit Verneinung) nicht im geringsten, nicht das geringste, gar nicht, ganz und gar nicht, nichts weniger als
経営 (けいえい): (1) Management, Leitung, Betrieb, Verwaltung, Bewirtschaftung, (2) Unternehmensmanagement, (3) Fundamentieren, Fundamentbau und Errichtung eines Hauses, (4) Vorbereitungen, Vorkehrungen, (5) Eilen, Hasten, betreiben, verwalten, leiten (einen Betrieb), führen (ein Hotel od. ein Restaurant), bewirtschaften
豪華 (ごうか): Pracht, Prunk, Luxus, Verschwendung, Üppigkeit, luxuriös, prachtvoll, prächtig, köstlich, prunkvoll, verschwenderisch, üppig
求める (もとめる): (1) zu erlangen wünschen, um etw. bitten, um etw. ansuchen, etw. verlangen, etw. fordern, (2) suchen, forschen, ausfindig machen, ermitteln, (3) kaufen, anschaffen, besorgen, organisieren, (4) verursachen, heraufbeschwören, sich etw. zuziehen
取れる (とれる): (1) abgehen, weggehen, (2) vorkommen, geben, abgebaut werden können, (3) verstehen können, auffassen können, (4) getroffen sein, aufgenommen sein, (1) gewonnen werden, geerntet werden, erzeugt werden, gefangen werden, (2) nachlassen, (3) aufgefasst werden, (4) abgehen, lösen, losgehen, abspringen, (5) verdient werden, (6) in Anspruch nehmen
成人 (せいじん): Erwachsener, erwachsen werden
負け (まけ): Niederlage, Verlust, Schlag
景気 (けいき): (1) Konjunktur, Geschäftslage, Stimmung, (2) Hochkonjunktur, gute Konjunktur, gute Geschäftslage (wie kō・keiki好景気), (3) Stand der Dinge, Situation, Zeitumstände, (4) Schwung
価格 (かかく): Preis, Kosten, Wert
砂漠 (さばく): Wüste, Sandwüste
誇り (ほこり): Stolz, Ruhm, Selbstbewusstsein, Selbstwertgefühl
半ば (なかば): (1) Hälfte, zur Hälfte, (2) Mitte, Mittel, (3) zum Teil, teilweise
記録 (きろく): (1) Aufzeichnung, Urkunde, Dokument, Akte, Archiv, Schriftstück, Protokoll, (2) Chronik, Annalen, (3) Speicherung, (4) Rekord, Höchstleistung, aufzeichnen, aufschreiben, buchen, protokollieren, registrieren
小麦 (こむぎ): Weizen, Triticum aestivum
ジュース: Gleichstand, Einstand, Saft, Fruchtsaft
気温 (きおん): Temperatur, Lufttemperatur, Außentemperatur
座席 (ざせき): Sitz, Platz, Sitzplatz
参考 (さんこう): Nachschlagen, Konsultieren, Belehrung, Hinweis, Verweis, Vergleich, Information
証明 (しょうめい): (1) Beweis, Zeugnis, Bescheinigung, Bestätigung, Verifikation, (2) Beweis, (3) Beweis, beweisen, bescheinigen, bestätigen, bezeugen
発展 (はってん): Entwicklung, Expansion, Entfaltung, Ausdehnung, Wachsen, Wachstum, Aufschwung, (1) sich entwickeln, sich entfalten, sich ausdehnen, sich ausweiten, wachsen, (2) eine liederliches Leben führen, das Leben genießen
精々 (せいぜい): (1) soweit wie nur möglich, möglichst, so weit wie möglich, (2) höchstens, nicht mehr als
シャベル: Schaufel, (1) Schaufel, (2) Löffelbagger
首相 (しゅしょう): Premierminister, Ministerpräsident, Kanzler (inoffizielle Bez.)
友 (とも): (1) Freund, Gefährte, Kamerad, (2) Begleiter, Freund (z.B. ein Buch oder die Natur als Freund)
恐怖 (きょうふ): Furcht, Schrecken, Grauen, Bange, sich fürchten, erschrecken, einen Schrecken bekommen, es graut jmdm, jmdn. überkommt das Grauen, gruseln
琴 (こと): Koto, Sō-no-koto, (nf) Koto, (nf) Sō-no-koto (versch. Typen der japan. Wölbbrettzither; 6‑ oder 13-saitig; am häufigsten wird das Sō-no-Koto – kurz Koto genannt – verwendet; moderne Kotos sind 180–190 cm lang und haben 13 oder mehr Saiten; die Saiten werden durch bewegliche Stege gestimmt und mit Plektren gespielt)
空 (から): (1) Leere, Leerheit, Hohlheit, (2) leer, ohne, (3) vorgeblich, nur zur Schau gestellt, (4) verfehlt, ergebnislos, leer, hohl, unausgefüllt, unbewohnt, unbewacht
とんでも無い (とんでもない): (1) unglaublich, erstaunlich, überraschend, fantastisch, (2) schrecklich, furchtbar, entsetzlich, (3) ungewöhnlich, außerordentlich, unerwartet, (4) unsinnig, widersinnig, töricht, dumm, unvernünftig, (5) (als Reaktion auf Lob oder Entschuldigung)Nein, nein!, (6) Auf keinen Fall!, (7) Ach wo!, (8) Überhaupt nicht!, (9) Aber ich bitte Sie!
書斎 (しょさい): Studierzimmer, Arbeitszimmer
様々 (さまざま): Verschiedenheit, Diversität, Mannigfaltigkeit, verschieden, verschiedenartig, mannigfaltig, allerlei
残す (のこす): (1) übrig lassen, (2) verlassen, zurücklassen, (3) ungetan lassen, unerledigt lassen, (4) sparen, aufheben, (5) jmdm. etw. hinterlassen, (6) im Ring bleiben
延期 (えんき): Aufschub, Hinausschieben, Verlegung auf später, Verzögerung, Vertagung, verlegen, verschieben, aufschieben, zurückstellen, vertagen
徹夜 (てつや): Nachtwache, Durchmachen, Aufbleiben, die Nacht durchmachen, die ganze Nacht aufbleiben, die Nacht durcharbeiten
理解 (りかい): Verständnis, Verstehen, Begreifen, Einsicht, verstehen, begreifen, erfassen, einsehen
ゴール: (1) Tor, Korb, Punkt, (2) Ziellinie, Ziel, Gallien (Gebiet Frankreichs im Altertum), ein Tor schießen
付く (つく): (1) haften, anhaften, kleben, (2) sich bilden, ansetzen, zunehmen, gewinnen, (3) dazugehören, bei jmdm. bleiben, (4) jmdm. folgen, jmds. Partei ergreifen, überlaufen, (5) berühren, in Berührung kommen, (6) kosten, (7) Glück haben
横断 (おうだん): (1) Durchschneiden nach der Breite, (2) Durchquerung, Traversierung, Überquerung (nach der Breite bzw. in Ost-West-Richtung), durchqueren, überqueren
叫ぶ (さけぶ): (1) schreien, aufschreien, rufen, kreischen, (2) nach … rufen, … fordern
未来 (みらい): (1) Zukunft, kommende Zeit, die späteren Tage, (2) Jenseits, zukünftiges Leben, (3) Futur, Futurum, in Zukunft, zukünftig
存在 (そんざい): Dasein, Existenz, Vorhandensein, da sein, sein, existieren, es gibt, zu finden sein, vorhanden sein, vorkommen
扱う (あつかう): (1) sich kümmern, (2) pflegen, behandeln, (3) bewirten, empfangen, (4) tratschen, Gerüchte verbreiten, (5) übertreiben, (6) umgehen mit …, bedienen, handhaben, manipulieren, gebrauchen, (7) beherrschen, (8) erledigen, durchführen, (9) versöhnen, ausgleichen, (10) sich mit der Handhabung plagen, (11) mit etw. spielen
解釈 (かいしゃく): (1) Interpretation, Auslegung, Auffassung, Deutung, (2) Erklärung, Erläuterung, Darlegung, Ausführung, (3) Anmerkung, Kommentar, (1) auffassen, deuten, interpretieren, verstehen, auslegen, (2) erklären, erläutern, auseinandersetzen, (3) kommentieren, mit Anmerkungen versehen
憲法 (けんぽう): Verfassung, Konstitution, konstitutionell, verfassungsgemäß
夫婦 (ふうふ): (1) Mann und Frau, Ehepaar, Eheleute, (2) Paar aus etw. Größerem und etw. Kleinerem, Mann und Frau, Ehepaar, Eheleute, verheiratetes Paar, Mann und Frau, Ehepaar, Eheleute
免許 (めんきょ): Erlaubnis, Lizenz, Genehmigung, Konzession, Zulassung, Führerschein, jmdm. eine Konzession erteilen, jmdm. eine behördliche Genehmigung erteilen
怠ける (なまける): faul sein, faulenzen, müßig sein, nichts tun, schwänzen, vernachlässigen, versäumen
高速 (こうそく): (1) hohe Geschwindigkeit, (2) Schnellstraße, Autobahn
異常 (いじょう): Ungewöhnlichkeit, Unnormalität, Abnormität, (1) ungewöhnlich, außergewöhnlich, abnorm, nicht regelrecht, unnatürlich, unnormal, (2) beispiellos, einzigartig, erstaunlich, ungeheuerlich, unvergleichlich, ungewöhnlich, unnormal, abnormal, (1) ungewöhnlich, außergewöhnlich, abnorm, nicht regelrecht, unnatürlich, unnormal, (2) beispiellos, einzigartig, erstaunlich, ungeheuerlich, unvergleichlich
自身 (じしん): selbst, sich, persönlich
家賃 (やちん): Miete, Hausmiete, Wohnungsmiete
ペンキ: Farbe (zum Anstreichen)
避ける (さける): ausweichen, vermeiden, beiseite treten, Platz machen, abwehren, meiden, vermeiden, umgehen, ausweichen, aus dem Weg gehen
警告 (けいこく): (1) Ermahnung, Mahnung, Warnung, Verwarnung, Erinnerung, Verweis, (2) Verwarnung bei unerlaubter Technik, warnen, mahnen, verwarnen, erinnern
満ちる (みちる): (1) voll werden, voll sein, erfüllt sein, (2) ablaufen, herum sein, (3) steigen (Flut), (4) voll werden, zunehmen (Mond)
感心 (かんしん): (1) Bewegung, Rührung, (2) Verblüffung, (3) Bewunderung, Anerkennung, Lobenswürdigkeit, bewundern, anerkennen, beeindruckt werden, schätzen, vorbildlich, bewundernswert, lobenswert, anerkennenswert, brav, geschätzt, tüchtig
許す (ゆるす): (1) vergeben, verzeihen, (2) erlauben, gestatten, zulassen, (3) gewähren (eine Bitte, einen Antrag), (4) befreien (von einer Pflicht oder einer Bürde), jmdm. etw. erlassen, jmdm. etw. ersparen, (5) gewähren lassen, machen lassen, dulden, (6) Vertrauen schenken, die Vorsicht sinken lassen, (7) anerkennen, achten, (8) lockern, lose machen (etw. fest Verschnürtes), (9) freilassen, loslassen
墓 (はか): Grab
悪口 (あっこう): (1) Beschimpfung, Beleidigung, (2) Verleumdung, üble Nachrede, schlechter über jmdn. reden, als es der Wirklichkeit entspricht, (3) Verleumdung (eine der zehn Sünden; vgl. akku), (1) Beschimpfung, Beleidigung, (2) Verleumdung, üble Nachrede, schlechter über jmdn. reden, als es der wirklichkeit entspricht, Verleumdung, üble Nachrede
敵 (てき): (1) Feind, Gegner, (2) Rivale, Gegenspieler, Konkurrent, Widersacher
提出 (ていしゅつ): Einbringen, Einbringung, Einreichung, Einreichen, Vorlegung, Antrag, Vorlage, einbringen, vorlegen, beantragen, einreichen, vorbringen, vorzeigen
操作 (そうさ): Bedienung, Handhabung, Verfahren, Behandlung, Behandlungsweise, Operation, Manipulation, Kunstgriff, Verrichtung, verfahren, behandeln, handhaben, manipulieren, operieren, verrichten
スタンド: (1) Tribüne, (2) Stehlampe, (3) Stand
物事 (ものごと): Ding, Sache, Angelegenheit
安定 (あんてい): (1) Stabilisierung, Beständigkeit, Unveränderlichkeit, (2) Stabilität, stabiles Gleichgewicht, sich stabilisieren, sich festigen, stabil
批評 (ひひょう): Kritik, Kommentar, Rezension, Besprechung, besprechen, kritisieren, kommentieren
注目 (ちゅうもく): Aufmerksamkeit, Beachtung, Aufsehen, Berücksichtigung, Acht geben, achten, beachten, seine Aufmerksamkeit richten auf
劣る (おとる): nachstehen, zurückstehen, unterlegen sein, minderwertig sein, schlechter sein
虎 (とら): (1) Tiger, Panthera tigris, (2) Betrunkener, Trinker
数 (かず): Zahl, Anzahl
加わる (くわわる): (1) beitreten, sich gesellen zu …, sich beteiligen, teilnehmen, mitmachen, (2) dazukommen, sich vermehren, sich vergrößern, größer werden, zunehmen, gewinnen
針 (はり): Angelhaken, (1) Nadel, Nähnadel, Stecknadel, Zwecke, (2) Akupunkturnadel, (3) Akupunktur, (4) Injektionsnadel, (5) Abtastnadel, Grammophonnadel, (6) Stachel, Dorn, (7) Zeiger, Kompassnadel, (8) Nähen, (9) Angelhaken, (10) Sticheln, (11) … Maschen, … Stiche (als Zählwort)
植物 (しょくぶつ): Pflanze
騒ぎ (さわぎ): (1) Lärm, Getöse, Geräusch, (2) Aufhebens, Getue, Theater, Tumult, (3) Orgie, lärmendes Gelage, (4) Skandal, Fall
候補 (こうほ): (1) Kandidatur, Kandidatenschaft, (2) Kandidat
眺める (ながめる): (1) betrachten, sehen, ansehen, (2) überblicken
騒音 (そうおん): Lärm,  (störendes)Geräusch
感動 (かんどう): Rührung, Ergriffenheit, Erschütterung, Bewegung, Eindruck, Begeisterung, ergriffen sein, bewegt sein, gerührt sein, sehr beeindruckt sein, begeistert sein
間 (ま): (1) Raum, Zwischenraum, Platz, (2) Zeitraum, Zwischenzeit, Zeit, (3) freie Zeit, (4) Zeit für etw, (5) Abstand zwischen zwei Pfosten eines Hauses, (6) Größe einer Tatami-Matte (regional unterschiedl.), (7) Raum, Zimmer, (8) Einheit für Zimmergröße, (9) Zählwort für Zimmer, (10) …Raum, …Zimmer, (11) Pause (in der japan. Mus.), (12) (übertr.)Rhythmus, (13) Sprechpause, (14) gute Gelegenheit, (15) Verfassung, Zustand, (16) Ankerplatz
何時でも (いつでも): jederzeit, zu jeder Zeit, immer, stets, jedes Mal, wann auch immer
信仰 (しんこう): Glaube, religiöse Überzeugung, glauben
釣り (つり): (1) Angeln, (2) Wechselgeld, Restgeld, Kleingeld, Tsuri
陰 (かげ): (1) Schatten, nicht von Licht beschienener Ort, (2) von etwas verdeckter Ort, (3) toter Winkel, nicht sichtbarer Ort, (4) Rückseite, (5) Silhouette, (6) Heimlichkeit, (7) kleines Fest außerhalb der Reihenfolge, (8) Empfangen einer Gunst, (9) Person, von der man eine Gunst empfängt
学者 (がくしゃ): Gelehrter, Wissenschaftler
主要 (しゅよう): Haupt…, Schlüssel…, wesentlich, Haupt…, wesentlich
情報 (じょうほう): (1) Information, Nachricht, Meldung, (2) Information, Aufklärung
外す (はずす): (1) lösen, losmachen, abmachen, abnehmen, abstellen, abkuppeln, absetzen, (2) verrenken, ausrenken, (3) verfehlen, nicht treffen, (4) sich entfernen, ausweichen, fortschleichen
約 (やく): ungefähr, etwa, rund, circa
賢い (かしこい): (1) weise, klug, intelligent, gescheit, verständig, bedachtsam, denkfähig, (2) ohne Fehler, (3) furchtsam, (4) ehrfürchtig, (5) adelig
観客 (かんきゃく): Zuschauer, Publikum (insbes. Kino, Theater etc.)
現代 (げんだい): (1) Gegenwart, Heute, unsere Zeit, (2) Moderne, modern, gegenwärtig
結ぶ (むすぶ): (1) binden, zusammenbinden, (2) verknüpfen, verbinden, (3) abschließen (Vertrag, Kontrakt), eingehen (einen Handel), (4) beendigen, enden, beschließen, zu Ende bringen, Schluss machen, (5) sich verbünden, sich zusammenschließen, konspirieren, (6) schließen (die Hand, den Mund), (7) (Früchte) tragen, (8) bilden (eine Form), (9) bauen, errichten, (10) die Haare zusammenbinden, frisieren, (11) (z.B. einen Aufsatz) zusammenfassen, (12) beenden (einen Satz), (13) mit Hand oder Fingern umfassen, festhalten, (14) mit der Hand schöpfen, (15) einen Reisball formen, (16) Äste einer Kiefer oder Grasblätter zusammenbinden (im Altertum als Zauber durchgeführt)
綿 (めん): Baumwolle
描く (えがく): (1) zeichnen, malen, skizzieren, (2) ein Bild entwerfen, (3) schildern, beschreiben, darstellen, (4) sich einbilden, sich denken, sich vorstellen, (1) malen, (2) beschreiben, darstellen, schildern
増す (ます): (1) sich vermehren, sich vergrößern, größer werden, sich verstärken, schwellen, zunehmen, steigen, (2) vermehren, ausdehnen, erhöhen, vergrößern, größer machen, verstärken
インク: Tinte
奪う (うばう): (1) wegnehmen, entreißen, rauben, plündern, (2) fesseln, gefangen nehmen, (3) entzücken, faszinieren
迷子 (まいご): (1) Sichverlaufen, Sichverirren, Abkommen vom Weg, Verlieren der Orientierung, (2) sich verlaufen habendes Kind, verloren gegangenes Kind, sich verirrt habendes Kind, vermisstes Kind, verschwundenes Kind
画家 (がか): Kunstmaler, Maler, Grafiker
代金 (だいきん): Preis, Gebühr, Rechnung, Zahlung
餌 (えさ): Futter, Köder, Fraß, Lockspeise, (1) Futter, Nahrung, (2) Beute, (3) Köder, Lockspeise
人ごみ (ひとごみ): Gedränge, Menschenmenge
何とか (なんとか): (1) irgendwie, irgendwas, auf die eine oder andere Art, (2) so und so, sowieso, ohnehin
頻りに (しきりに): (1) sehr häufig, oft, andauernd, ständig, unaufhörlich, ununterbrochen, wiederholt, (2) eifrig, angestrengt, zäh, nachdrücklich
屯 (トン): (1) Tonne, (2) Tonnage, (1) Stationierung, Lagerung, (2) Lager, Garnison, Kaserne
滞在 (たいざい): Aufenthalt, sich aufhalten, verweilen
恩 (おん): Gnade, Gunst, Barmherzigkeit, Güte, Liebe, Wohltat, Mitleid, Mitgefühl, Sympathie, Freundlichkeit, Wohlwollen, Dankbarkeit
建築 (けんちく): (1) Bauen, Bau, Errichtung, (2) Bauwerk, Gebäude, Architektur, bauen, aufbauen, erbauen, errichten
呼吸 (こきゅう): (1) Ein‑ und Ausatmen, Atem, Atemzug, Atmung, (2) Kunstgriff, Kniff, Tip, Trick, (3) Harmonie, gute Einstellung auf etw, (4) Atmung, Respiration, (5) (äußere)Atmung, Lungenatmung, (6) innere Atmung, Zellatmung, atmen, aus‑ und einatmen, Atem holen, aufatmen
都 (みやこ): Hauptstadt, Regierungssitz, Stadt, Miyako
対する (たいする): (1) gegenüberstehen, widerstehen, (2) gegen, für, zu, gegenüber, vor, im Verhältnis zu, hinsichtlich
義務 (ぎむ): (1) Pflicht, Verpflichtung, Schuldigkeit, Verantwortlichkeit, (2) Pflicht, (3) Verpflichtung
肩 (かた): (1) Schulter, Achsel, (2) Ansatz der Vorderbeine, (3) Flügelansatz, (4) Schulter, Schulterteil, (5) Bergschulter, (6) Anfang der Steigung eines Weges, (7) oberer Teil von etw, (8) Wurfkraft, (9) Tragkraft, (10) (übertr.)Verantwortung, Verpflichtung, (11) Schicksal (nach buddhistischen Gottheiten, die auf den Schultern eines Menschen sitzen und dessen Taten protokollieren, um sie dem König der Unterwelt zu berichten)
一層 (いっそう): (1) mehr, immer mehr, noch mehr, um so mehr, (2) ein Geschoss, ein Stockwerk
過ごす (すごす): (1) verbringen, verleben (Zeit), (2) überschreiten, hinausgehen, das Maß überschreiten, (3) (an Renyō・kei) etw. übergehen, (4) etw. übertrieben, etw. zu lang tun
占める (しめる): besetzen, einnehmen
衛星 (えいせい): (1) Mond, Trabant, Satellit, (2) Satellit, künstlicher Satellit
飯 (めし): (1) gekochter Reis, (2) Mahlzeit, (3) jmds. tägliches Brot
平ら (たいら): (1) Fläche, (2) Ebenheit, Glattheit, (3) Bequemheit, eben, flach, glatt
監督 (かんとく): (1) Aufsicht, Überwachung, Kontrolle, (2) Aufseher, Kontrolleur, Leiter, (3) Regie, Regisseur, (4) Mannschaftsleiter, Trainer, (5) rechtliche Leitung, (6) Bischof (in der protestant. Kirche Japans), kontrollieren, beaufsichtigen, Aufsicht führen, Regie führen
轢く (ひく): überfahren
束 (たば): Bündel, Bund, Strauß, Garbe
手間 (てま): (1) Zeit und Mühe, (2) Lohn (Abk.), (3) Arbeit eines Handwerkers
選手 (せんしゅ): Sportler, Spieler, Aktiver
否定 (ひてい): (1) Verneinung, Verleugnung, Negation, Ablehnung, (2) Negation, verneinen, dementieren, leugnen, ableugnen, bestreiten
別れ (わかれ): Abschied, Trennung
一方 (いっぽう): (1) eine Seite, eine Richtung, (2) eine von zwei Seiten, eines von zweien, (3) auf der einen Seite, einerseits, andererseits, (4) übrigens, (5) nur, (6) eine Gegend, eine Seite, die andere Seite, (7) Hingabe, (8) der andere
首都 (しゅと): Hauptstadt, Hauptstadt…, Metropol…
互い (たがい): gegenseitig, einander, sich
有利 (ゆうり): (1) Profit, (2) Vorteil, vorteilhaft, günstig, ertragfähig, profitabel, lukrativ
一種 (いっしゅ): eine Art, eine Gattung, eine Sorte
覆う (おおう): (1) bedecken, einhüllen, verhüllen, (2) verdecken, verschleiern, (3) beschützen, verhehlen, (4) beschirmen, abschirmen, schützen
キャンプ: (1) Camp, Zeltlager, Zeltplatz, Lager, Lagerplatz, (2) Gefangenenlager, kampieren, campen, zelten
不利 (ふり): (1) Nachteil, (2) schlechte Situation, ungünstige Lage, Nachteiligkeit, Benachteiligung, nachteilig, ungünstig
苦しむ (くるしむ): (1) leiden (körperlich und geistig), Schmerzen haben, sich quälen, sich abquälen, Schmerz empfinden, Kummer haben, verlegen sein, ratlos sein, (2) schwierig sein, in Schwierigkeiten sein, (3) Not leiden, in Not sein, (4) sich quälen (körperlich und psychisch), plagen, peinigen
皮 (かわ): (1) Leder, Haut, (2) Fell, Pelz, (3) Rinde, Borke, (4) Schale, Pelle, Kruste
外交 (がいこう): (1) Diplomatie, diplomatische Beziehungen, Außenpolitik, Auslandsbeziehungen, (2) Außendienst (insbes. einer Bank, Versicherung, Handelsgesellschaft etc.)
制度 (せいど): System, Einrichtung, Institution, Organisation, Verfassung, Wesen
蕎麦 (そば): (1) Buchweizen, Fagopyrum esculentum, (2) Soba, Buchweizennudeln
理想 (りそう): Ideal, Hochziel
堪らない (たまらない): (1) unerträglich sein, etw. nicht ertragen können, (2) bald kaputt gehen, ruiniert werden, (3) nicht anders können, als …, etw. unbedingt wollen, (4) unvergleichlich sein, die Vorstellung übersteigen, überglücklich sein
犯罪 (はんざい): Verbrechen, Delikt, Frevel, Straftat
面 (めん): (1) Gesicht, (2) Maske, Kopfschutz, (3) Men, Schlag auf die Maske, (4) Seite einer Zeitung, (5) Aspekt, Hinsicht, (6) Seite, Oberfläche
ハイキング: Wandern, Wanderung
常識 (じょうしき): (1) Verstand, Vernunft, gesunder Menschenverstand, Grips, (2) Allgemeinwissen, bekannte Tatsache
エネルギー: Energie
場 (ば): (1) Platz, Stelle, Ort, (2) Raum, Platz, Sitzplatz, (3) Szene, Auftritt, (4) Feld, (5) Gebiet, (6) Sitzung
誤り (あやまり): Fehler, Irrtum
アイスクリーム: Speiseeis, Eiscreme, Eis
土地 (とち): (1) Grundstück, Baugrund, (2) Grund, Land, Boden, (3) Gegend
因る (よる): (1) verursacht sein von …, kommen von …, stammen von …, … verdanken, … zuzuschreiben sein, abhängen von …, sich anlehnen an …, (2) dienen zu …, beruhen auf …, (3) die Grundlage bilden für …, die Ursache sein für …, (4) den Stützpunkt abgeben, (5) entsprechend, gemäß, mittels, laut, (6) sich beziehen auf …, mit … in Beziehung stehen
見当 (けんとう): (1) Ziel, Richtung, (2) Schätzung, Schätzwert, (3) ungefähr
分野 (ぶんや): Bereich, Gebiet, Fach, Feld, Zweig
離婚 (りこん): Scheidung, Ehescheidung, sich scheiden lassen, geschieden werden
乗せる (のせる): (1) jmdn. fahren, jmdn. einsteigen lassen, jmdn. an Bord nehmen, (2) jmdn. fahren lassen, (3) jmdn. aufnehmen, (4) tragen, jmdn. täuschen, (1) beladen, aufladen, (2) setzen, legen, stellen, (3) schreiben, veröffentlichen, eintragen, verzeichnen
今にも (いまにも): jeden Augenblick
国家 (こっか): Staat, Nation, Land, Reich, Volk, Politeia, Der Staat (staatstheoretisches Hauptwerk von Platon)
ドラマ: Drama
悪魔 (あくま): (1) Dämon, der die Lehre Buddhas behindert, Māra, (2) Teufel, Dämon, (3) Satan, böser Geist, (4) sehr grausamer Mensch
銀 (ぎん): (1) Silber, (2) Silberfarbe, (1) Silber (Zeichen: Ag; lat. Argentum), (2) Silbermünze, (3) Geld, Bargeld, (4) Silbergeneral, Silberfeldherr, Silber (eine Spielfigur; Abk.), silbern
機能 (きのう): Funktion, Tätigkeit, Fähigkeit, Wirkung, funktionieren
決まり (きまり): (1) Festsetzung, Abschluss, Bestimmung, Entscheidung, (2) Ordnung, Regelmäßigkeit, (3) Regel, Vorschrift, Gewohnheit, Brauch, Sitte, ordentlich, regelmäßig
飛行 (ひこう): Flug, Fliegen, Luftfahrt, fliegen
生地 (きじ): (1) Stoff, Kleiderstoff, (2) noch unglasierte Keramik, Biskuitporzellan, (3) jmds. wahres Gesicht, (4) Teig
管 (かん): (1) Rohr, Röhre, (2) Blasinstrument, (3) Zählwort für Flöten, Pinsel etc., (1) Rohr, Röhre, Schlauch, (2) Spule für den Schussfaden, (3) Spindel, (4) kleine Flöte aus Horn, die auf dem Schlachtfeld verwendet wurde
永久 (えいきゅう): Ewigkeit, auf immer und ewig, für immer, ewig, Ewigkeit, Unveränderlichkeit, Ewigkeit, Permanenz, Zeitlosigkeit, Eikyū (Nebenlesung: Yōkyū; Ärabez.: 13.7.1113–3.4.1118), für immer, ewig, ewig, für immer, auf immer und ewig, ewig
莫大 (ばくだい): Riesengröße, riesig, riesengroß, enorm, ungeheuer, immens
経由 (けいゆ): (1) Ort, der auf dem Weg passiert wird, (2) über …, routen über …, leiten über …
大部分 (だいぶぶん): (1) Großteil, der größte Teil, der größere Teil, Mehrheit, (2) über fünfzig Prozent, größtenteils, zum größten Teil
抵抗 (ていこう): Widerstand, Opposition, Widerstreben, Trotz, Resistenz, widerstehen, Widerstand leisten, sich widersetzen, Trotz bieten, opponieren
詩 (し): Dichtung, Gedicht
学ぶ (まなぶ): (1) lernen, erlernen, studieren, (2) Unterricht nehmen, Stunden nehmen, (3) studieren, forschen, Wissenschaft betreiben, (4) Erfahrungen sammeln, Kenntnisse und Weisheit erlangen, (5) nachahmen, imitieren, (6) sich gewöhnen
奇妙 (きみょう): (1) Seltsamkeit, Sonderbarkeit, Absonderlichkeit, (2) Unerklärlichkeit, Merkwürdigkeit, (3) Strangeness, Seltsamkeit, Fremdheitsquantenzahl, Absonderlichkeit, Seltsamkeit, Kuriosität, seltsam, sonderbar, absonderlich, kurios, merkwürdig, wunderlich
鋏 (はさみ): (1) Schere, (2) Knipszange, Knipser, Lochzange, (3) Schere (beim Stein-Schere-Papier-Spiel)
天然 (てんねん): Natur…, natürlich
きつい: (1) stark, tapfer, mutig, charaktervoll, (2) streng, scharf, grimmig, schrecklich, fürchterlich, wütend, (3) hart, schwer, feurig, heftig, (4) eng, knapp, schmal, steil
間違い (まちがい): (1) Irrtum, Fehler, Missgriff, Fehlgriff, Versehen, Druckfehler, Rechenfehler, Schreibfehler, Tippfehler, Schnitzer, (2) Unfall, Unglück, (3) Streit, Streitigkeiten, Händel, (4) Fehltritt, Seitensprung, Dummheit
スター: (1) Star, Topstar, (2) Stern, Sternchen, Asterisk, *
涙 (なみだ): Träne (in der Edo-Zeit unter den Bediensteten verwendet), (1) Träne, (2) Gefühl
額 (がく): (1) Bild, Wandbild, (2) Rahmen, Bilderrahmen, (3) Menge, Summe, Betrag, (4) (insbes.)Geldbetrag, (5) Verwendung eines Bildmusters für den Stoff eines Haori, (6) Ichibu・gin, längliche Münze vom Wert eines Viertel Mon (gegen Ende der Edo-Zeit im Umlauf)
筋肉 (きんにく): Muskel, Muskelfleisch, muskulär, Muskel…
例 (れい): (1) Gepflogenheit, Brauch, Gewohnheit, Sitte, (2) Präzedenzfall, Präzedens, (3) Beispiel, Beispielsfall, Vorbild, (4) der Fragliche
代理 (だいり): Vertretung, Stellvertretung, Agentur, Stellvertreter, Agent, Bevollmächtigter, vertreten, die Vertretung übernehmen, kommissarisch, stellvertretend, vorübergehend
級 (きゅう): (1) Schulklasse, Klasse, (2) Kyū, Schülergrad (mit verschiedenfarbigen Gürteln gekennzeichnet: weiß, gelb, orange, grün, blau, braun), (3) viertel Millimeter (Einheit für den Fotosatz)
欠ける (かける): (1) abbrechen, abbröckeln, stückweise abgehen, (2) fehlen, mangeln, abgehen, entbehren, ermangeln, gebrechen, (3) abnehmen (Mond)
券 (けん): (1) Karte, Coupon, Schein, Marke, Papier, (2) Besitzurkunde über Land bzw. über ein Shōen
逮捕 (たいほ): Festnahme, Gefangennahme, Verhaftung, festnehmen, gefangen nehmen, verhaften, dingfest machen
恋 (こい): Liebe, Leidenschaft, Zuneigung, Minne
示す (しめす): zeigen
物理 (ぶつり): Physik
額 (ひたい): Stirn
検査 (けんさ): Untersuchung, Prüfung, Durchsuchung, Revision, Besichtigung, Inspektion, untersuchen, prüfen
勢い (いきおい): (1) (2) 
経つ (たつ): vergehen, vorbeigehen, verfließen, verrinnen, vorbeigehen, verstreichen
方々 (ほうぼう): überall, alle Richtungen, alle Seiten, überall, allerorten, in jeder Richtung
届く (とどく): (1) erreichen, reichen, ankommen, eintreffen, geliefert werden, (2) erreichen, langen an, (3) sich erfüllen, erhört werden
夫人 (ふじん): (1) Frau, Gattin, (2) Frau ….
破る (やぶる): schlagen, besiegen, (1) zerreißen, zerbrechen, (2) kaputt machen, (3) übertreten, verletzen, verstoßen (Gesetz), (4) brechen (einen Vertrag), (5) besiegen, schlagen
マイク: Mikrofon, Mikro (Abk.)
預ける (あずける): anvertrauen, betrauen, zur Aufbewahrung geben, deponieren, in Obhut geben
容器 (ようき): Gefäß, Behälter, Behältnis
心理 (しんり): Seelenzustand, Gemütsverfassung, Psyche, Mentalität
少しも (すこしも): nicht im geringsten, gar nicht (mit Verneinung)
泡 (あわ): Schaum, Blase, Schaum
園 (その): Garten, Park, (1) Garten, Park, (2) bestimmter Ort (um etw. zu tun), Platz, Stelle
歓迎 (かんげい): Willkommen, Begrüßung, freundliche Aufnahme, freundlicher Empfang, willkommen heißen, freudig begrüßen, freundlich aufnehmen, einen freundlichen Empfang bereiten
土曜 (どよう): Samstag, Sonnabend (Abk.)
輝く (かがやく): (1) strahlen, scheinen, glänzen, leuchten, funkeln, schimmern, (2) hell werden, sich aufhellen, (3) erröten, sich schämen, peinlich berührt werden, (4) prächtig sein, herrlich sein, hervorragend sein
作家 (さっか): Schriftsteller, Dichter, Autor
権利 (けんり): (1) Recht, Anrecht, Rechtsanspruch, Berechtigung, Vorrecht, (2) Freiheit, etw. zu tun oder dies zu lassen, (3) Macht und der Profit aus dieser Macht
熱中 (ねっちゅう): Begeisterung, Schwärmen, sich begeistern, enthusiastisch sein
嫌う (きらう): (1) nicht mögen, nicht gern haben, verabscheuen, hassen, Abneigung empfinden, Widerwillen haben, (2) meiden, (3) nicht vertragen, (4) unterscheiden (mit Verneinung: also unterschiedslos), (5) vermeiden
来 (らい): Rai
節約 (せつやく): Sparsamkeit, Wirtschaftlichkeit, sparsam sein, sparen
日本 (にほん): Japan (Inselstaat in Ostasien; ca. 127 Mio. Einwohner)
宝 (たから): (1) Schatz, Kostbarkeit, (2) Juwel, Kleinod, etw. Wertvolles, (3) Reichtum, Gut, Besitz
夢中 (むちゅう): (1) Hingerissenheit, Versunkenheit, Begeisterung, Unbesonnenheit, (2) im Traum
流れる (ながれる): (1) fließen, strömen, plätschern, hervorbrechen, rieseln, (2) weggeschwemmt werden, weggespült werden, (3) verfließen, vergehen, verfliegen, verrinnen, verstreichen, (4) getrieben werden, (5) vagabundieren, herumwandern, sich treiben lassen, ohne Wohnsitz leben, (6) verfallen, (7) hinneigen, die Neigung haben, tendieren zu, (8) abgesagt werden (ein Treffen), (9) daneben gehen
幼い (おさない): (1) jung, (2) unschuldig, rein und unverdorben, kindlich, jung, klein, kindlich, kindisch, grün, unerfahren
其れでも (それでも): aber, trotzdem, jedoch, allein
男子 (だんし): Junge, Mann
消防 (しょうぼう): (1) Brandbekämpfung, (2) Feuerwehr, Feuerlöschwesen
敬意 (けいい): Achtung, Hochachtung, Respekt, Verehrung, Ehrerbietung, Ehrfurcht
作法 (さほう): (1) Manieren, Sitten, Etikette, (2) Methode
毛布 (もうふ): Wolldecke, Decke
幅 (はば): (1) Breite, Weite, (2) Breite, Latitüde, (3) Einfluss, (4) Unterschied, Marge
銅貨 (どうか): Kupfermünze
諺 (ことわざ): Sprichwort, Spruch, Sinnspruch, Maxime
進歩 (しんぽ): Fortschritt, Fortgang, Entwicklung, fortschreiten, Fortschritte machen
吠える (ほえる): bellen, kläffen, heulen, jaulen, brüllen, brummen, schreien
向ける (むける): (1) zuwenden, etw. richten auf …, drehen, lenken, (2) den Weg auf ein Ziel lenken, zustreben lassen, (3) auf etw. abzielen, (4) senden, absenden, (5) aufteilen, zuteilen (Dinge od. Geld), (6) unterdrücken, (7) darbringen, opfern
夜明け (よあけ): Tagesanbruch, Morgendämmerung
個人 (こじん): Individuum, Privatperson, Privatmensch, Einzelperson
或いは (あるいは): (1) (2) , (1) oder, (2) vielleicht, vermutlich, wahrscheinlich, wohl
貢献 (こうけん): Beitrag, Dienst, beitragen, einen Beitrag leisten, einen Dienst erweisen
生まれ (うまれ): Geburt, Herkunft, Abstammung, Abkunft
通信 (つうしん): (1) Kommunikation, Korrespondenz, Nachricht, Information, Bericht, Mitteilung, Verbindung, (2) Nachrichtenübertragung, Datenübertragung, (3) Nachrichtenagentur, Nachrichtendienst (Abk.), kommunizieren, Nachricht geben
ダンス: Tanz, Tanzen, tanzen
関心 (かんしん): (1) Interesse, Neugier, (2) Anteilnahme, Aufmerksamkeit, Sorge
大臣 (だいじん): Minister, Ministerin
祭 (まつり): (1) Fest, Feier, Schreinfest, Tempelfest, Festtag, Matsuri, (2) Kulthandlung zu Ehren der Ahnen
予防 (よぼう): Vorbeugung, Verhütung, Prävention, Schutz, Vorsicht, vorbeugen, verhüten
料金 (りょうきん): Gebühren, Abgabe, Tarif (z.B. bei Telefon, Internet etc.)
全国 (ぜんこく): das ganze Land, alle Länder, landesweit
霧 (きり): Nebel
便り (たより): Nachricht, Schreiben, Brief, Mitteilung, Kunde, Post (meist 便り), jmdm. schreiben, jmdm. eine Nachricht zu kommen lassen
列車 (れっしゃ): Zug, Eisenbahnzug
帰宅 (きたく): Heimkehr (ins eigene Haus), Rückkunft, Heimkommen, Nachhausekommen, nach Hause gehen, heimkehren
盛り (さかり): (1) Höhepunkt, Gipfel, Blütezeit, Blüte, (2) Blütezeit des Lebens, (3) Brunst, Läufigkeit, Hitze
収穫 (しゅうかく): Ernte, ernten
缶 (かん): (1) Blechdose, Büchse, Kanister, Tonne, (2) Konserve, Konservendose, (3) Zählwort für Dosen, Kanister etc.
記事 (きじ): (1) Artikel, Bericht, Zeitungsbericht, Nachricht, (2) Beschreibung, beschreibender Aufsatz
週 (しゅう): Woche
球 (きゅう): Ball, Kugel, Globus, Sphäre
主婦 (しゅふ): Hausfrau
大陸 (たいりく): Kontinent, Festland, Erdteil, kontinental
礼儀 (れいぎ): Höflichkeit, Etikette, Anstand, Schicklichkeit, gesellschaftliches Auftreten, gute Manieren, Sitte, gute Umgangsformen
粗い (あらい): grob (z.B. eine Struktur, Material, Arbeit), rau (z.B. eine Oberfläche)
期待 (きたい): Erwartung, Hoffnung, Traum, Antizipation, Aussicht, Vertrauen, Ahnung, erwarten, rechnen mit, hoffen auf, zählen auf, bauen auf, sich verlassen auf
曜日 (ようび): Wochentag
ビデオ: Video
粗末 (そまつ): (1) einfach, schlicht, grob, rau, schlecht, minderwertig, ungeschliffen, (2) nachlässig, unachtsam
用心 (ようじん): Vorsicht, Umsicht, Aufmerksamkeit, Behutsamkeit, vorsichtig sein, Vorsicht walten lassen, sich in Acht nehmen
喋る (しゃべる): (1) reden, schwatzen, plaudern, plappern, (2) ausplaudern, ausschwatzen, sich verplappern
温度 (おんど): Temperatur, Wärmegrad
実際 (じっさい): (1) Wahrheit, Tatsache, Wirklichkeit, (2) Praxis, (3) Realität, Sachverhalt, Lage, wirklich, tatsächlich, konkret, real, wahrpraktisch, faktisch
然も (しかも): (1) noch dazu, außerdem, überdies, ferner, weiter, zudem, (2) trotzdem, gleichwohl, dennoch
籠 (かご): (1) Käfig, (2) Korb
ぼんやり: (1) Zerstreutheit, Abwesenheit, Hirngespinste, (2) dummer Kerl, Idiot, (3) unklar, vage, versunken sein, abwesend sein, verträumt sein
生憎 (あいにく): leider, unglücklicherweise, ungelegen, zu ungelegener Zeit, unglücklich, unpassend, ungelegen, unzeitig
財産 (ざいさん): (1) Vermögen, Eigentum, Hab und Gut, Besitz, (2) Anwesen, Haus und Hof, Immobilien, Habseligkeiten
共同 (きょうどう): (1) Zusammenarbeit, Kooperation, Partnerschaft, (2) Gemeinsamkeit, gemeinsamer Besitz, Kyōdō (japan. Nachrichtenagentur; gegr. 1945 als Genossenschaft von Presse- und Rundfunkunternehmen; Sitz: Tōkyō), sich vereinigen, in Gemeinschaft tun, mitarbeiten, mitwirken, zusammenarbeiten, sich anschließen, gemeinschaftlich, gemeinsam, gemein, allgemein, Kooperation, Zusammenarbeit, partnerschaftliche Aktivität, zusammenarbeiten
訴える (うったえる): (1) klagen, anklagen, Anklage erheben, verklagen, einen Prozess führen, (2) klagen, sich beschweren, sich beklagen, (3) appellieren, sich wenden an, (4) beeindrucken
腐る (くさる): (1) verfaulen, verderben, schlecht werden, verwesen, verrosten, (2) die Stimmung verderben, (3) den Charakter verderben
迷惑 (めいわく): Belästigung, Störung, Unannehmlichkeit, lästig, unangenehm
婦人 (ふじん): Frau, Dame, das weibliche Geschlecht
医師 (いし): (1) Arzt, Mediziner,  (med.)Doktor, (2) Medizinalrat (nach dem Ritsuryō-System bzw. in der Edo-Zeit)
博士 (はかせ): (1) informierte Person, Gelehrter, (2) Doktor (akad. Titel), Doktorgrad, Doktor (akad. Titel), Doktorgrad
道路 (どうろ): Straße, Weg
向い (むかい): gegenüberliegende Seite, gegenüberliegend
縁 (ふち): (1) Rand, Kante, (2) Rahmen, Einfassung, (3) Krempe, Saum, Felge, (4) Beschlag an der Öffnung des Schwertgriffes
発行 (はっこう): (1) Herausgabe, Veröffentlichung, Publikation, (2) Ausstellung (von Bescheinigungen o.Ä.), (1) herausbringen, veröffentlichen, (2) emittieren
地下 (ちか): (1) Untergrund, Erde, Erdboden, (2) Grab, (3) Untergrund, in der Erde, im Untergrund, (1) unterirdisch, unter der Erde, unter Tage, (2) jenseitig
傷 (きず): (1) Verletzung (durch Schlag oder Schnitt), Wunde, Verwundung, Blessur, Trauma, Stelle, Narbe, (2) Beschädigung (bes. der Oberfläche einer Sache), Fehler, Sprung, Riss, Kratzer, (3) Fehler, Schwäche, Makel, (4) Beschädigung des Rufs, Schande, Unehre, (5) (seelische)Verletzung
去る (さる): vergangener …, letzter …, (1) fortgehen, weggehen (einen Ort) verlassen, sich entfernen, abhauen, aufbrechen, abfahren, abfliegen, abreisen, (2) vergehen, vorübergehen (Zeit), (3) vergehen, verschwinden, schwinden, nachlassen, abnehmen, weggehen (z.B. eine Gefahr, Krankheit etc.), (4) entfernt sein, (5) vollständig … tun, (6) fernhalten, sich vom Leib halten, (7) sich von seiner Frau trennen, sich scheiden lassen, (8) meiden, vermeiden, umgehen, (9) absagen, ablehnen, (10) Verse von einander trennen (bei Kettengedichten)
役割 (やくわり): Rolle
付ける (つける): (1) befestigen, anheften, auflegen, ankleben, annähen, anschmieren, (2) einen Preis ansetzen, Preis bieten, (3) anmachen, anzünden, anschalten, (4) nachfolgen, verfolgen, (5) anziehen, anlegen, anhaben, tragen, (1) anziehen, tragen, (2) stehen bleiben, anhalten, festmachen
栄養 (えいよう): (1) Ernährung, Nahrungsaufnahme, (2) Nährwert, Nahrhaftigkeit
失業 (しつぎょう): Arbeitslosigkeit, arbeitslos sein, keine Arbeit mehr haben, seine Stellung verlieren, Stempeln gehen
自然 (しぜん): Natur, natürlich, von Natur, von Natur aus, von innen heraus, von sich aus, von selbst, automatisch, natürlich, naturhaft, angeboren, instinktiv, spontan, selbsttätig, automatisch, autogen, ungekünstelt, unbefangen, ungesucht
支配 (しはい): (1) Herrschaft, Regierung, Kontrolle, Führung, Verwaltung, Dominanz, (2) Rektion, (3) Überwertigkeit, herrschen, beherrschen, regieren, kontrollieren
思想 (しそう): (1) Idee, Gedanke, Anschauung, Auffassung, Begriff, (2) …‑Ideologie
食料 (しょくりょう): Lebensmittel, Nahrungsmittel, Proviant
読み (よみ): (1) Lesung, Aussprache, (2) Einsicht, Verständnis, Weitblick, Voraussicht, Urteilsfähigkeit
刷る (する): drucken, vervielfältigen
ケース: (1) Fall, (2) Etui, Vitrine, Gehäuse, Verkleidung
知らせ (しらせ): (1) Nachricht, Mitteilung, Benachrichtigung, Meldung, (2) Vorahnung, Omen, Vorzeichen
信用 (しんよう): (1) Vertrauen, Zutrauen, Glauben, (2) Vertrauenswürdigkeit, Ruf, (3) Kredit, trauen, vertrauen, zutrauen, Vertrauen schenken, Vertrauen setzen in, Vertrauen haben
係 (かかり): (1) Amt, Pflicht, Aufgabe, Zuständigkeit, (2) Person mit einem bestimmten Amt, verantwortliche Person, zuständige Person, Zuständiger, (3) postpositionelle Korrelation, (4) Beziehung, Bezug, Zusammenhang
段 (だん): (1) (2) 
発表 (はっぴょう): Verkündigung, Bekanntmachung, Bekanntgabe, Veröffentlichung, veröffentlichen, ankündigen, bekannt machen
倒す (たおす): (1) fällen, umwerfen, umstürzen, (2) stürzen, (3) besiegen, überwältigen, (4) erschlagen, erlegen, ums Leben bringen
材料 (ざいりょう): (1) Material, Stoff, Rohstoff, Werkstoff, Ausgangsmaterial, Zutaten, (2) Daten, (3) Faktor
ママ: (1) Mama, Mami, Mutter, (2) Barchefin, Wirtin, Managerin
保存 (ほぞん): (1) Erhaltung, Bewahrung, Verwahrung, Instandhaltung, Unterhaltung, Konservierung, (2) Sichern, Speichern (von Daten), (1) erhalten, bewahren, verwahren, instand halten, in gutem Zustand halten, konservieren, einmachen, (2) sichern, speichern
環境 (かんきょう): (1) Umwelt, Umgebung, Milieu, umgebende Welt, Umstände, Lebensumstände, (2) direkte Umgebung, angrenzendes Gebiet
穴 (あな): (1) Loch, Höhle, Senke, Beule, Öffnung, Ritze, Spalte, Leck, (2) Höhle, Loch, Bau, (3) Lücke, Defizit, Verlust, Mangel, (4) vergessener Winkel, Versteck, (5) unbekannte Angelegenheit, unbekannter Ort, (6) unerwarteter Augang eines Rennens, Ausgang mit hohem Wettgewinn, (7) Außenseiter, Überraschungssieger, (8) Parkett, (9) Grab, Gruft, Grube, (10) (Edo-Zeit) unbekannte Seite
逆らう (さからう): (1) gegen etwas gehen, gegen etwas schwimmen, (2) opponieren, sich widersetzen, widerstreben, trotzen, nicht gehorchen
ベルト: (1) Gürtel, (2) Band, Treibriemen
ぐっすり: tief schlafend
ダイヤ: Diagramm, Fahrplan, (1) Diamant, (2) Karo, Diagramm, Fahrplan
清潔 (せいけつ): Reinheit, Reinlichkeit, Sauberkeit, rein, sauber
梅雨 (つゆ): Regenzeit (Juni–Juli)
不自由 (ふじゆう): (1) Unbequemlichkeit, Unannehmlichkeit, Einschränkung, (2) Mangel, Not, Armut, (3) Behinderung, (1) unbequem, unangenehm, (2) mangelhaft, notleidend, arm, kümmerlich, (3) behindert
不幸 (ふこう): (1) Unglück, Unglücksfall, Unfall, Missgeschick, Elend, Pech, (2) Tod, Hinscheiden (eines nahen Verwandten), unglücklich, elend, jämmerlich, unglückselig, unheilvoll
堀 (ほり): Hori, Graben, Kanal, Wassergraben, Burggraben, Schlossgraben, Wallgraben
調子 (ちょうし): (1) Ton, Tonlage, Klang, Stimmung, (2) Form, Befinden, Kondition, Zustand, Art und Weise, (3) Tempo, Geschwindigkeit
岩 (いわ): (1) Gestein, Fels, (2) Felsblock, Felsen, Klippe, Riff
世の中 (よのなか): (1) Welt, Gesellschaft, (2) weltliche Umstände, weltliche Dinge, (3) Leben, (4) Zeiten, Zeitalter, (5) Regierungszeit, Zeit der Regentschaft, (6) diese Welt, Gegenwart, (7) gesellschaftliches Ansehen, (8) Beziehung zwischen Mann und Frau, Liebe, (9) Menschenleben, (10) äußere Umstände, umgebende Natur, (11) Arbeitsergebnis, Resultat
地球 (ちきゅう): Erde, Erdkugel, Erdball, terrestrisch, irdisch, weltlich, Erd…
金額 (きんがく): Geldsumme, Geldbetrag, Geldposten
痛み (いたみ): (1) Schmerz, Weh, Pein, Qual, Leid, Kummer, Betrübnis, (2) Schaden, Verlust, Beschädigung, Druckstelle, Fäule
手伝い (てつだい): (1) Hilfe, Unterstützung, (2) Helfer, Hausmädchen
稲 (いね): Reis, Reispflanze, Oryza sativa
時刻 (じこく): Zeit, Stunde
振る (ふる): (1) schwingen, schwenken (Fahne), wedeln (Schwanz), läuten (Glocke), (2) nicken, schütteln, winken, (3) streuen (Salz), versprengen, werfen (Würfel), (4) (etw. an einen anderen Ort) verlegen, (5) mit etw. versehen (Kanji mit Furigana), zuteilen, zuweisen (Aufgabe, Rolle), (6) verzichten auf, (7) abweisen, zurückweisen, eine Abfuhr erteilen, einen Korb geben, (8) abdrehen, schwenken, einlenken, (9) absieden, abkochen, (10) ausgeben, ziehen, trassieren (Wechsel, Scheck)
処理 (しょり): (1) Erledigung, Verrichtung, Handhabung, Behandlung, Entsorgung, Beseitigung, Klärung, Abschreibung, (2) Verarbeitung, (1) erledigen (Akten), besorgen, behandeln (z.B. chemisch), bearbeiten, mit etw. verfahren, (2) (Müll) beseitigen, (3) fertig werden mit einem Problem
制限 (せいげん): Begrenzung, Beschränkung, Einschränkung, Grenze, beschränken, begrenzen, Schranken setzen
裸 (はだか): (1) Nacktheit, Unbekleidetsein, (2) Unbedecktheit, Unverhülltsein, Unverkleidetheit, (3) Mittellosigkeit,  Besitz von nichts anderem als seinem Körper, (4) Offenheit, nackt, unbekleidet,  (ugs.) nackig
営業 (えいぎょう): (1) Betrieb, Geschäft, Gewerbe, Handel, (2) Verkauf, Vertrieb, (3) Gewerbe, ein Gewerbe ausüben, ein Geschäft betreiben
比較 (ひかく): Vergleich, vergleichen, einen Vergleich anstellen
パイプ: (1) Pfeife, Zigarettenspitze, (2) Rohr, (3) Vermittler, (4) Pipeline
隠す (かくす): (1) verstecken, verbergen, verhehlen, verdecken, verhüllen, (2) verheimlichen, verschweigen, geheim halten, hinter dem Berg halten, für sich behalten, (3) begraben, (4) die Wahrheit verbergen, lügen, (5) ausblenden
無 (む): Nichts
開始 (かいし): Beginn, Anfang, Start, Eröffnung, anfangen, beginnen
王様 (おうさま): (1) König, (2) Seine Majestät, Euer Majestät
夫れ夫れ (それぞれ): jeder für sich, jeweils, einzeln, getrennt
率 (りつ): (1) Satz, Rate, (2) Gewinn
気候 (きこう): (1) Klima, (2) (langfristiges)Wetter
罪 (つみ): (1) Sünde, Schuld, Verantwortung, Verbrechen, Delikt, Vergehen, Verstoß, Fehler, (2) Strafe, Bestrafung, (3) Verantwortung, Fehler, (4) Verantwortungslosigkeit, verantwortungslos, grausam, herzlos
お互い (おたがい): gegenseitig
歌手 (かしゅ): Sänger, Sängerin
商品 (しょうひん): Ware, Handelsware, Artikel, Handelsartikel, Handelsgut, Gut
真剣 (しんけん): (1) voller Ernst, Ernsthaftigkeit, (2) echtes Schwert, Ernsthaftigkeit, ernst, ernsthaft, im Ernst, allen Ernstes, ernsthaft
伸びる (のびる): (1) länger werden, sich ausstrecken, wachsen, sich vergrößern, zunehmen, sich ausdehnen, sich glätten, (2) verschoben werden, aufgeschoben werden, sich verlängern, vertagt werden, (3) sich ausbreiten, (1) sich verlängern, länger werden, sich ausdehnen, (2) überdehnen, sich ausdehnen und dabei die Elastizität verlieren, (3) sich hinziehen, sich hinstrecken, lange andauern, sich verzögern, (4) Fortschritte machen, vorrücken, sich vorwärts bewegen, (5) müde sein, erschöpft sein, schwach werden, umkippen, in Ohnmacht fallen
年間 (ねんかん): (1) … Jahre lang, (2) innerhalb eines Jahres, (3) in den Jahren der …‑Zeit
骨折 (こっせつ): Knochenbruch, Fraktur, sich die Knochen brechen
記念 (きねん): Erinnerung, Andenken, Angedenken, Gedächtnis, gedenken, ein Andenken feiern, erinnern
責任 (せきにん): Verantwortung, Verantwortlichkeit, Pflicht, Schuld, Schuldigkeit, Haftung
構成 (こうせい): Zusammensetzung, Aufbau, Struktur, Bildung, Gefüge, Konstruktion, Organisation, zusammensetzen, aufbauen, bauen, bilden, konstruieren, organisieren
州 (しゅう): (1) (2) 
取り上げる (とりあげる): (1) in die Hand nehmen, aufheben, annehmen, (2) wegnehmen, entziehen, in Beschlag nehmen, (3) aufnehmen, annehmen, akzeptieren, aufgreifen, (4) entbinden, gebären
判断 (はんだん): Urteil, Entscheidung, Beurteilung, Ansicht, Ermessen, Deutung, urteilen, beurteilen
正確 (せいかく): Genauigkeit, Präzision, Richtigkeit, Pünktlichkeit, Exaktheit, Korrektheit, genau, richtig, pünktlich, korrekt, präzis, exakt, in richtiger Weise, genau, korrekt, präzise
引用 (いんよう): Anführung, Zitieren, Zitatbeleg, anführen, zitieren
委員 (いいん): (1) Mitglied (eines Ausschusses od. Komitees), Komiteemitglied, Ausschussmitglied, durch Wahl oder aufgrund von Empfehlung für Beratung, Untersuchung oder Bearbeitung ausgewählte Person, (2) Klassensprecher
依頼 (いらい): (1) Auftrag, Bitte, Gesuch, (2) Abhängigkeit, (1) beauftragen mit, bitten um, abhängig sein, (2) sich verlassen auf, rechnen mit
備える (そなえる): (1) sich ausrüsten, sich vorbereiten, vorbeugen, Vorkehrungen treffen, vorsorgen, (2) haben, besitzen, begabt sein mit, (3) versehen, ausstatten, einrichten, installieren
掴む (つかむ): (1) greifen, fassen, festhalten, packen, fangen, ergreifen, (2) begreifen, erfassen, verstehen
者 (もの): Person, jemand
そっくり: (1) alle, alles, insgesamt, (2) genau so aussehen, wie …, ein Ebenbild sein von …
奨学金 (しょうがくきん): Stipendium
ジェット機 (ジェットき): Düsenflugzeug
徐々 (じょじょ): langsam, nach und nach, allmählich, gemächlich, schrittweise, langsam, langsam aber beständig, nach und nach, allmählich, gemächlich, schrittweise
溺れる (おぼれる): (1) ertrinken, ersaufen, (2) sich ergeben, sich hingeben, nicht loskommen
悩む (なやむ): (1) beunruhigt sein, sich Sorgen machen, (2) leiden, (3) jemandem schwerfallen
謎 (なぞ): (1) Rätsel, Mysterium, (2) Hinweis
小屋 (こや): (1) Hütte, Baracke, Häuschen, Kate, Bude, Schuppen, Verschlag, (2) Stall, (3) Zelt, (4) Theater, (1) kleines Haus, Hütte, (2) mein bescheidenes Haus (besch. Bez. für das eigene Haus)
菓子 (かし): Süßigkeit, Konfekt, Kuchen, Konditorwaren, Gebäck
参加 (さんか): Teilnahme, Beteiligung, teilnehmen, sich beteiligen, mitwirken
抜ける (ぬける): (1) ausfallen, abbrechen, ausgehen, abgehen, verlieren, (2) fehlen, ausbleiben, nicht da sein, vermisst werden, (3) verschwinden, entkommen, entweichen, entfliehen, (4) austreten, herauskommen, (5) durchgehen
推薦 (すいせん): Empfehlung, empfehlen
鉄道 (てつどう): Eisenbahn
批判 (ひはん): Kritik, Begutachtung, kritische Beurteilung, kritische Bemerkung, kritisieren, kritisch beurteilen, prüfen, untersuchen
刺激 (しげき): (1) Anregung, Reiz, Stimulanz, Ansporn, (2) Reiz, Stimulus, anregen, aufregen, reizen, anspornen, antreiben, anregen
住民 (じゅうみん): Bewohner, Einwohner, Bürger, Bevölkerung, Einwohnerschaft
近頃 (ちかごろ): in letzter Zeit, neuerdings, heutzutage, heute, vor kurzem
能 (のう): (1) Talent, Begabung, Funktion, Fähigkeit, Können, (2) Nō, Nō-Drama, Nō-Spiel (japan. Drama mit orchestraler Begleitung; wird ausschließlich von männl. Schauspielern in prächtigen Gewändern und Masken aufgeführt; die Stoffe entstammen meist der älteren Literatur und Geschichte; Begründer des Nō sind Kanami Kiyotsugu und sein Sohn Zeami Motokiyo)
魅力 (みりょく): Reiz, Charme, Zauber, Anziehungskraft
職 (しょく): (1) Anstellung, Amt, Posten, Stelle, Beruf, Arbeit, (2) Beschäftigung, Berufung
中央 (ちゅうおう): (1) Mitte, Zentrum, (2) Hauptstadt, Regierung, Chūō-Universität, Chūō・daigaku (private Universität in Tōkyō; Vorläufer gegründet 1885; jetziger Name seit 1905; seit 1920 rechtlich Universität; Hauptsitz ist Hachiōji; Abk.), Chūō (einer von 23 Stadtbezirken in Tōkyō), in der Mitte, im Zentrum, zentral, Zentral-, Mittel-
水準 (すいじゅん): Niveau, Wasserhöhe, Wasserstand, Durchschnitt
頭痛 (ずつう): (1) Kopfschmerzen, (2) Sorgen, Ärger, Kopfschmerzen
前進 (ぜんしん): Vorrücken, Vormarsch, vorrücken, vormarschieren
増加 (ぞうか): Zunahme, Zuwachs, Vermehrung, Anwachsen, Wachstum, zunehmen, anwachsen, sich vermehren
海外 (かいがい): Übersee, Ausland, im Ausland, ausländisch
だが: (1) aber, allein, dennoch, obgleich, doch, (2) weil
抜く (ぬく): (1) herausziehen, entfernen, (2) beseitigen, (3) auslassen, weglassen, (4) überholen, hinter sich lassen, übertreffen, (5) einnehmen, erobern, (6) auszugsweise nehmen, (7) den Durchbruch schaffen
停留所 (ていりゅうじょ): Haltestelle
鼠 (ねずみ): (1) Maus, Ratte (Abk.), (2) Mausgrau (Abk.), (1) Maus, Ratte, (2) Mausgrau
始まり (はじまり): (1) Anfang, Beginn, (2) Einleitung, (3) Ursache, Grund
ノック: Klopfen, klopfen
報告 (ほうこく): Bericht, Berichterstattung, Auskunft, Meldung, Mitteilung, berichten, Bericht erstatten, benachrichtigen, Nachricht geben, melden, mitteilen
演奏 (えんそう): Musikaufführung, Konzert, musikalische Darbietung, spielen, vortragen, darbieten
付き合い (つきあい): gesellschaftlicher Umgang, Verkehr, Geselligkeit, gesellschaftliche Beziehungen
覚ます (さます): (1) aufwachen, wach werden, erwachen, (2) nüchtern werden, (3) aus einem Irrtum aufwachen, Illusionen verlieren, (4) Trauer od. Unsicherheit stillen
急激 (きゅうげき): Plötzlichkeit, Schlagartigkeit, Ruckartigkeit, Drastik, plötzlich, jäh, schlagartig, ruckartig, drastisch, plötzlich, abrupt, drastisch
表面 (ひょうめん): (1) Oberfläche, Außenseite, Vorderseite, Oberseite, Gesichtsseite, (2) Äußeres, Äußerliches, (3) Anschein, Erscheinung, (1) äußerlich, auf der Außenseite, (2) oberflächlich, scheinbar
連れ (つれ): (1) Begleiter, Gefährte, (2) Tsure (begleitende Figur eines Nō-Stückes)
誠に (まことに): in der Tat, in Wahrheit, (1) tatsächlich, in der Tat, wirklich, in Wahrheit, wahrhaftig, ehrlich, (2) höchst, gewaltig, kolossal, riesig, (3) herzlich
一体 (いったい): (1) ein Körper, (2) eine Buddhastatue, ein Standbild, (3) eine Erscheinung, (4) im Allgemeinen, generell, (5) denn, überhaupt, eigentlich, im Grunde, in der Tat, tatsächlich, wirklich, (6) denn, nun, was in aller Welt, wer in aller Welt
訓練 (くんれん): (1) Übung, Training, Schulung, Ausbildung, Dressur, (2) Drill, Drillen, die Schüler eine Übung wiederholen lassen, bis sie diese können, (3) praktische Übung, einüben, trainieren, schulen, ausbilden, drillen
招く (まねく): (1) einladen, (2) herbeiwinken, (3) berufen, ernennen, (4) verursachen, heraufbeschwören, sich etw. zuziehen
発見 (はっけん): Entdeckung, entdecken, finden, aufdecken
勘定 (かんじょう): (1) Rechnen, Zählen, Nachzählen, (2) Rechnung, Bezahlung, Ausgleich, Begleichung, (3) Schätzung, Überschlag, (4) Berechnung, Abrechnung, (5) Beamter des Schatzamtes, (1) rechnen, berechen, (2) zählen, aufzählen, nachzählen, (3) bezahlen, begleichen, ausgleichen, entrichten, abrechen
無し (なし): ohne …
基づく (もとづく): (1) kommen von, zurückführen auf, entstehen aus, Ursache haben in, verursachen, (2) beruhen auf, sich gründen auf, sich stützen auf, basieren auf, zugrunde liegen, (3) sich richten nach
丸 (まる): (1) Kreis, Ring, Rund, Zirkel, (2) Kugelform, (3) Geld (verschleiernd), (4) Burg, Schloss, Ringmauer einer Burg, (5) Vollständigkeit
姉妹 (しまい): (1) Schwestern, (2) Assoziation, Partnerschaft
別に (べつに): (1) anders, unterschiedlich, besonders, (2) nichts Besonderes (mit Verneinung)
精神 (せいしん): (1) Geist, Seele, Psyche, Moral, Sinn, Wille, (2) Mentalität, Einstellung, Gemütsart, (3) Idee, Geist, gemeinter Inhalt
与える (あたえる): (1) geben, (2) zuteilen, stellen, (3) verursachen
礼 (れい): (1) Gruß, Begrüßung, Salut, Verbeugung, (2) gute Manieren, Höflichkeit, gute Umgangsformen, Etikette, (3) Dank, Dankbarkeit, Vergütung, Honorar, Geschenk, Revanche
急速 (きゅうそく): Schnelligkeit, Geschwindigkeit, schnell, rasch, geschwind, schnell, rasch, mit Schnelligkeit, geschwind
不安 (ふあん): (1) Angst, Unsicherheit, ungutes Gefühl, Unruhe, Sorge, Besorgnis, Besorgtheit, Ungewissheit, (2) Angst (z.B. bei Kierkegaard oder Heidegger), unruhig, ängstlich, besorgt, sorgenvoll, ungewiss, unsicher
知能 (ちのう): Intelligenz, Geisteskraft, intellektuelle Fähigkeit, Intellekt, Verstand
底 (そこ): (1) Boden, Grund, (2) Sohle, (3) Bett (eines Flusses), Meeresboden, (4) Inneres, Tiefe, (5) der tiefste Preis (im Markt)
