最も (もっとも): (1) aber, jedoch, doch, allerdings, gleichwohl, (2) natürlich, glaubhaft, plausibel, vernünftig, verständlich, kein Wunder sein, dass …, am meisten, am höchsten, am wichtigsten, äußerst, höchst, äußerst, am meisten (zur Bildung des Superlativs)
草 (くさ): (1) Gras, Kraut, Unkraut, Grünfutter, (2) Amateur…, Dorf…
道具 (どうぐ): (1) Werkzeug, Gerät, Gerätschaften, Utensilien, Geschirr, (2) Bauten, Kulissen
昼休み (ひるやすみ): Mittagspause
事故 (じこ): (1) Unfall, Unglück, Unglücksfall, Vorfall, Zwischenfall, (2) Hindernis, Störung, Schwierigkeit, Verhinderung, Behinderung, (3) Angelegenheit, Sache, Umstände
下宿 (げしゅく): (1) Untermiete, Wohnen zur Untermiete, (2) Pension, (3) Ryōkan von niederem Rang, (4) Gast eines niederrangigen Ryōkan, (5) Ferien des Dienstpersonals, zur Untermiete wohnen
匂い (におい): (1) Gestank, übler Geruch, (2) Anflug (von etwas Unangenehmen), Geruch, Duft, Aroma, Wohlgeruch
増える (ふえる): zunehmen, sich vermehren, mehr werden, anwachsen, größer werden, stärker werden, anwachsen, anschwellen
訪ねる (たずねる): besuchen, einen Besuch machen, aufsuchen, vorbeischauen, vorbeikommen, vorsprechen
時代 (じだい): Zeit, Zeiten, Zeitalter, Periode, Ära, Epoche
ステーキ: Steak
呉れる (くれる): (1) geben, weggeben, vergeben, (2) schenken, spenden, bescheren, (3) etw. für jmdn. tun
大分 (だいぶ): ziemlich, bedeutend, sehr, beträchtlich, erheblich, recht, in hohem Grade
都 (と): (1) Hauptstadt, Metropole, (2) Hauptstadtpräfektur, (3) Stadt
熱心 (ねっしん): Eifer, Fleiß, Begeisterung, Leidenschaft, Enthusiasmus, Teilnahme, Lust, eifrig, fleißig, leidenschaftlich, begeistert, teilnahmsvoll, mit Eifer, eifrig, mit Fleiß. fleißig, leidenschaftlich, begeistert, mit Begeisterung, mit Lust, teilnahmsvoll
輸入 (ゆにゅう): Einfuhr, Import, einführen, importieren
急 (きゅう): (1) Schnelligkeit, Reißend, (2) Plötzlichkeit, (3) Bevorstehen, Drohen, (4) Steilheit, Schroffheit, (5) Ernsthaftigkeit, Strenge, (6) Ungeduld, Hast, (7) Notfall, dringender Fall, Gefahr, Krise, Not, Notfall, (8) Eile, Dringlichkeit, (9) gefährliche Angelegenheit, (10) Finale, dritte Phase im Spannungsverlauf eines Theater- oder Musikstückes, (1) dringend, dringlich, eilig, sofortige, unerwartet, plötzlich, (2) steil, schnell, reißend
新聞社 (しんぶんしゃ): Zeitungsverlag
興味 (きょうみ): Interesse, Neugier, Anteilnahme, Begeisterung
倍 (ばい): (1) doppelt, zweifach, zweimal, (2) …fach
漫画 (まんが): (mn) Manga, (mn) Cartoon, Comic, Karikatur, Bildergeschichte
夢 (ゆめ): (1) Traum, (2) Wunschtraum, (3) Vision, Illusion, Einbildung, (4) etwas, das nicht wahr ist, etwas, das sich als Illusion erweist
似る (にる): ähnlich sein, ähnlich sehen, ähneln, erinnern an
祖父 (そふ): Großvater (mütterlicherseits), (1) Großvater, (2) alter Mann, Großvater, Opa
招待 (しょうたい): Einladung, einladen, zu sich bitten
以下 (いか): (1) … und weniger, weniger als …, nicht mehr als …, (2) unter …, unterhalb von …, (3) das Folgende, das Untenstehende, folgendes, wie folgt, (4) Samurai, der nicht qualifiziert ist, den Shōgun zu sehen, weniger als, unter
テキスト: (1) Text, (2) Original, Originaltext, (3) Lehrbuch, Text
戻る (もどる): (1) zurückgehen, zurückkehren, zurückkommen, heimkehren, (2) umkehren, kehrtmachen, den Weg zurückgehen, (3) wieder zum Vorschein kommen, (4) wieder zurückbekommen, wiedererstattet bekommen
硬い (かたい): (1) hart, solide, fest, eng, zuverlässig, (2) streng, rigoros, (3) unverrückbar, (4) sicher, (5) steif, hölzern, (6) zäh, (7) ernst, aufrichtig, (8) treu, tugendhaft, (9) entschlossen, entschieden, resolut, (10) hartnäckig, stur, starrköpfig
下げる (さげる): (1) senken, (2) hängen lassen, herunterhängen lassen, (3) baumeln lassen, hängen, schlenkern, (4) tragen, umhängen, (5) herabsetzen, herablassen, herunternehmen, (6) entfernen, abräumen, wegtun (etw. das sich neben einem Buddha, Gott oder einer hochrangigen Person befindet), (7) geben, erteilen, verleihen (eine hochstehende Person an eine niedriger stehende), (8) nach hinten bewegen, (9) abheben (Geld bei der Bank)
区 (く): (1) Zone, Gebiet, (2) Bezirk (nach dem Gesetz über die lokale Selbstverwaltung), Verwaltungsbezirk, (3) Bezirk, (4) (z.B.)Schulbezirk, Gerichtsbezirk
子 (こ): (1) Kind, Säugling, Junge, Mädchen, Sohn, Tochter, Nachkommenschaft, (2) Junges, Brut, Wurf, Rogen, Laich
会場 (かいじょう): Versammlungssaal, Versammlungshalle, Versammlungsraum, Versammlungsort
非常に (ひじょうに): sehr, überaus, außergewöhnlich
生活 (せいかつ): (1) Leben, Alltagsleben, Existenz, Dasein, (2) Lebenshaltung, Lebensunterhalt, leben, ein Leben führen
季節 (きせつ): (1) Jahreszeit, (2) Saison, Hauptzeit, Zeit, Hauptgeschäftszeit, Hauptverkehrszeit, jahreszeitlich
発音 (はつおん): Aussprache, Artikulation, aussprechen
放送 (ほうそう): Rundfunk, Rundfunksendung, Radio und Fernsehen, Sendung, Ausstrahlung, senden, im Rundfunk senden, durch Rundfunk übertragen, im Rundfunk sprechen
中々 (なかなか): (1) ziemlich, sehr, (2) nicht einfach, kaum
押し入れ (おしいれ): japanischer Einbauwandschrank mit Schiebetüren (z.B. für Futon), Wandschrank
怒る (おこる): zornig werden, zürnen, sich ärgern, ärgerlich sein, sich entrüsten, erbittert sein, in Zorn geraten, verdrießlich werden, (1) zornig werden, wütend werden, ärgerlich werden, böse sein, sich aufregen, (2) schelten, schimpfen (weil man sich über jemanden ärgert und nicht um ihn zu besseren Einsicht zu bringen)
最後 (さいご): Ende, Schluss, am Ende, zuletzt, schließlich, der letzte …
髪 (かみ): Haar, Kopfhaar, Frisur, Haartracht
些とも (ちっとも): (1) überhaupt nicht, kein bisschen, nicht einen Moment (mit Verneinung verwendet), (2) ein wenig, ein bisschen
準備 (じゅんび): Vorbereitung, Vorkehrung, Vorsorge, vorbereiten, Vorkehrungen treffen, Vorsorge treffen, sich anschicken
絹 (きぬ): (1) Seidenfaser, Seidengespinst, Seide, (2) Seidenstoff, Seide
屋上 (おくじょう): (1) Bereich auf dem Dach, (2) (insbes.)Flachdach, flaches Dach
昔 (むかし): (1) frühere Zeiten, vergangene Zeiten, verflossene Tage, (2) Früheres, Vergangenes, (3) Gestern, Urzeit, Altertum, Vorzeit, alte Zeit, (4) früher, damals, einst, anno dazumal, vor Jahr und Tag, vormals, (5) zehn Jahre (Zählwort für jeweils zehn Jahre in der Vergangenheit), alt, früher, gewesen, urzeitlich, vorzeitlich, verflossen, vergangen, verwichen, altertümlich, altmodisch
原因 (げんいん): Ursache, Grund, Anlass, Veranlassung, Wurzel, verursachen
泳ぎ方 (およぎかた): Schwimmweise
ハンバーグ: Hamburger (Abk.), Hamburg (Bundesland und Stadt an der Elbe)
是非 (ぜひ): (1) Recht und Unrecht, (2) Urteilen über Gut oder Schlecht, Für und Wider, Kritisieren, (3) unbedingt, auf jeden Fall, ganz gewiss, unter allen Umständen, koste es, was es wolle
周り (まわり): (1) Umfang, Kreisumfang, Peripherie, (2) Nähe, Umkreis, Umgebung, Nachbarschaft
嬉しい (うれしい): (1) froh, fröhlich, glücklich, erfreut, (2) sich freuen
赤ちゃん (あかちゃん): Baby, Säugling
出席 (しゅっせき): Anwesenheit, Präsenz, Gegenwart, Teilnahme, anwesend sein, zugegen sein, beiwohnen, besuchen
看護師 (かんごし): Krankenschwester, Krankenpfleger (für beide Geschlechter verwendete Bez.; inzwischen z.B. in Gesetzestexten die bevorzugte Version)
駐車場 (ちゅうしゃじょう): Parkplatz
石 (いし): (1) Stein, Kiesel, (2) Edelstein
苛める (いじめる): quälen, ärgern, mobben, misshandeln, belästigen, drangsalieren, übel mitspielen
遅れる (おくれる): (1) sich verspäten, zu spät kommen, zu spät sein, unpünktlich sein, überfällig sein, (2) zurückliegen, zurück sein, zurückbleiben, (3) überflügelt werden, (4) verzagen, den Mut verlieren, (5) nachgehen (Uhr)
先ず (まず): (1) zuerst, zunächst, (2) wohl, auf jeden Fall
凄い (すごい): (1) unheimlich, nicht geheuer, ungeheuer, gruselig, (2) fürchterlich, furchtbar, schrecklich, entsetzlich, (3) wahnsinnig, toll, großartig, fabelhaft
選ぶ (えらぶ): (1) auswählen, auserwählen, auslesen, (2) wählen, (3) lieber mögen, vorziehen, (4) festlegen
電灯 (でんとう): elektrisches Licht, elektrische Lampe
人口 (じんこう): Bevölkerung, Bevölkerungszahl, Einwohnerzahl
程 (ほど): (1) Grenze, Maß, Grad, (2) ungefähr, etwa, (3) so … wie, (4) je mehr desto …
習慣 (しゅうかん): (1) Brauch, Sitte, Gepflogenheit, (2) Gewohnheit, gewohnheitsmäßig
承知 (しょうち): (1) Einwilligung, Zustimmung, (2) Wissen, Kenntnis, (3) Erlaubnis, Vergebung, (1) anerkennen, einwilligen, einverstanden sein, (2) Kenntnis haben, wissen, erfahren
関係 (かんけい): (1) Beziehung, Bezug, Verbindung, Verhältnis, (2) Verhältnis, Liebschaft, wilde Ehe, (3) Beischlaf, Geschlechtsverkehr, (4) Verwandtschaftsbeziehung, (5) Interesse, Belang, Teilnahme, Anteil, (6) Einfluss, Einwirkung, Zusammenhang, (1) in Verbindung stehen, in Bezug stehen, sich beziehen, Beziehung haben, zusammenhängen, mit etw. zu tun haben, etw. angehen, von Belang sein, interessiert sein, in etw. verwickelt sein, beteiligt sein, (2) beeinflussen, einwirken, Einfluss ausüben, (3) mit jmdm. schlafen
届ける (とどける): (1) melden, benachrichtigen, (2) senden, liefern, schicken, zuschicken, abgeben
邪魔 (じゃま): Störung, Belästigung, Hindernis, Hemmnis, Behinderung, Einmischung, Hürde, Widerstand, Beeinträchtigung, stören, hindern, behindern, etw. in den Weg legen, im Weg stehen, in die Quere kommen, lästig fallen, durchkreuzen, sabotieren, sich einmischen, störend, lästig, hinderlich, hemmend
規則 (きそく): (1) Bestimmung, Vorschrift, Festsetzung, (2) Regel, Norm, Ordnung, System, Disziplin, (3) Satzung, Statut
答え (こたえ): Antwort, Erwiderung, Entgegnung, Reaktion, Effekt, Reaktion, Wirkung, Effekt, (1) Antwort, Erwiderung, Entgegnung, (2) Bescheid, Ergebnis, Lösung
沸く (わく): (1) kochen, sieden, heiß werden, (2) in Aufruhr geraten, toben, außer Rand und Band geraten
文法 (ぶんぽう): Grammatik, grammatisch, grammatikalisch
形 (かたち): (1) äußere Form, Gestalt, Fasson, Figur, (2) Form, Formalität, Formsache, (3) Aussehen, Gesichtszüge, Gesichtsausdruck, (4) Spur, Reste, (5) Körper, Leib
過ぎる (すぎる): (1) vorübergehen, vorbeigehen, vorbeifahren, durchziehen, passieren, (2) vergehen, dahingehen, dahinschwinden, enteilen, (3) den Höhepunkt überschreiten, (4) übertreiben, zu weit treiben, zu sehr tun, allzu …, (5) überschreiten, hinausgehen über …
幾らでも (いくらでも): so viel man mag
急行 (きゅうこう): (1) Eile, Hast, (2) Eilzug, D-Zug, Schnellzug (Abk. für kyūkō・ressha 急行列車), eilen, schnell gehen, schnell fahren, sich schleunigst begeben
就いて (ついて): (1) über, von, in bezug auf, bezüglich, in betreff, in Hinsicht auf, hinsichtlich, (2) mit …, in Begleitung von …, (3) entlang, (4) bei, unter, (5) pro, je, per
テニス: Tennis
残る (のこる): (1) übrigbleiben, zurückbleiben, (2) bleiben, (3) erhalten bleiben, unversehrt bleiben, (4) weitergeben, tradieren, (5) im Ring bleiben
講堂 (こうどう): (1) Hörsaal, Aula, Vortragssaal, Auditorium, (2) Predigthalle
中学校 (ちゅうがっこう): Mittelschule
以上 (いじょう): (1) und mehr, mehr als, nicht unter, über, (2) Gebiet über etw, (3) oben erwähnt, oben Stehendes, (4) da, weil, nachdem, (5) drüber hinaus, (6) Samurai bzw. Samuraistand, der qualifiziert ist, den Shōgun zu sehen
番組 (ばんぐみ): Programm, Rundfunksendung, Fernsehsendung
あっ: oh!, ah!, oje! (bei Überraschung, Erschrecken, Schmerz), Ach!, O!, Huch!, Ah!, Oh! (bei Schreck oder Überraschung)
為 (ため): (1) um zu, damit, (2) wegen, aufgrund, (3) Wohl, Nutzen
痩せる (やせる): (1) abmagern, schlank werden, dünn werden, (2) steril werden, seine Fruchtbarkeit verlieren
チェック: (1) Scheck, Cheque, (2) Karo, (3) Kontrolle, Vergleich, Überprüfung, (4) Ankreuzen, (1) kontrollieren, überprüfen, (2) ankreuzen, markieren, (3) auschecken, kariert
数学 (すうがく): Mathematik
失敗 (しっぱい): Misserfolg, Misslingen, Fehlschlag, Fiasko, Versagen, keinen Erfolg haben, daneben gehen, misslingen, missraten, ein Fiasko erleiden, fehlschlagen, versagen, erfolglos
ずっと: (1) dauernd, die ganze Zeit, fortwährend, lange, lange Zeit, vor langer Zeit, (2) viel, bei weitem, (1) direkt, gerade aus, (2) dauernd, die ganze Zeit, fortwährend, (3) lange, lange Zeit, vor langer Zeit, (4) viel, bei weitem
大体 (だいたい): (1) im Großen und Ganzen, ungefähr, wohl, fast, etwa, beinahe, (2) überhaupt, Hauptpunkt, das Wesentliche, (3) in erster Linie
拝見 (はいけん): Sehen, Ansehen (besch.-höfl.), sehen, ansehen, anschauen, betrachten
校長 (こうちょう): Schulleiter, Schuldirektor
理由 (りゆう): Mangel, Macke, Makel, Fehler, Grund, Ursache, Motiv, Anlass, Beweggrund, Veranlassung
調べる (しらべる): untersuchen, prüfen, erforschen, ermitteln, nachforschen, durchsehen, nachschlagen, verhören, zensieren
高校生 (こうこうせい): Oberschüler
頑張る (がんばる): (1) (bis zum Ende) durchhalten, weitermachen, nicht aufgeben, (2) sich anstrengen, sich bemühen, (3) (auf der eigenen Meinung) bestehen, (4) die eigene Position halten
貿易 (ぼうえき): Handel, Überseehandel, Außenhandel, Export und Import, Handel treiben
塗る (ぬる): (1) streichen, anstreichen, malen, (2) bewerfen (mit Putz), stuckieren, (3) tünchen, firnissen, glasieren, (4) schminken, (5) die Schuld aufbürden, anschwärzen, in die Schuhe schieben, zur Last legen
取り替える (とりかえる): (1) wechseln, umtauschen, (2) erneuern, ersetzen, austauschen
焼ける (やける): eifersüchtig sein, jmdm. etw. neiden, (1) brennen, abbrennen, zerstört werden, (2) gebraten werden, geröstet werden, gebacken werden, getoastet werden, (3) einen Sonnenbrand bekommen, von der Sonne verbrannt werden, braun werden, (4) sich rot verfärben, verschießen, (5) Sodbrennen haben, (6) rot sein, rötlich glänzen, glühen
ベル: (1) Andrew Bell (brit. Geistlicher und Pädagoge; 1753–1838), (2) Alexander Graham Bell (britisch-kanad. Erfinder; 1847–1922), (3) Charles Bell (schott. Anatom; 1774–1842), Klingel, Türglocke, Glocke, Heinrich Böll (dtsch. Schriftsteller; 1917–1985)
予約 (よやく): Vorbestellung, Reservierung, Subskription, Abonnement, Anmeldung, vorbestellen, vorher bestellen, reservieren, abonnieren, subskribieren, anmelden
サンダル: Sandale
祖母 (そぼ): Großmutter, Oma
木綿 (もめん): (1) Kapokbaum, Bombax ceiba, Bombax malabaricum, (2) Baumwolle, Gossypium arboreum, (1) Baumwolle, Gossypium arboreum, (2) Baumwollstoff
約束 (やくそく): (1) Versprechen, Abmachung, Vertrag, Bedingung, (2) Verabredung, Rendezvous, Date, (3) Konvention, Statuten, (4) Bestimmung, vorbestimmtes Schicksal, versprechen, verabreden
珍しい (めずらしい): (1) ungewöhnlich, selten, rar, (2) neu, neuartig, (3) wertvoll
首 (くび): (1) Kopf, Haupt, (2) Hals, Nacken, (3) (Metapher für)Entlassung
会議 (かいぎ): Konferenz, Sitzung, Beratung, Besprechung, Kongress, Versammlung, konferieren, eine Besprechung abhalten
残念 (ざんねん): Bedauern, Enttäuschung, Ärger, bedauerlich, bedauernswert, schade, ärgerlich, enttäuschend
正月 (しょうがつ): (1) Neujahr, Neujahrsfeiertage, (2) Januar, Hartung, (3) Grund für Zufriedenheit und Freude
戦争 (せんそう): Krieg, Feindseligkeiten, Schlacht, Gefecht, Krieg führen, bekriegen
森 (もり): Mori, Wald, Forst
掏摸 (すり): (1) Taschendiebstahl, (2) Taschendieb
踊り (おどり): Tanz, Tanzen
訳 (わけ): (1) Grund, Ursache, das Warum, Anlass, (2) Bedeutung, Sinn, (3) Umstände, Verhältnisse, Sache, Dinge, Fall, Sachverhalt, (4) Vernunft
ガソリンスタンド: Tankstelle
返事 (へんじ): Antwort, Erwiderung, Entgegnung, antworten, eine Antwort geben
港 (みなと): Minato (einer von 23 Stadtbezirken in Tōkyō), Hafen, Minato
地震 (じしん): Erdbeben
亡くなる (なくなる): versterben, sterben, entschlafen, hinscheiden, von hinnen gehen
集まる (あつまる): (1) sich versammeln, zusammenkommen, sich scharen, (2) sich vereinigen, sich konzentrieren, (3) eingesammelt werden, gesammelt werden
割合 (わりあい): (1) Verhältnis, Proportion, Prozentsatz, (2) Anteil, Beitrag, Quote, (3) vergleichsweise, verhältnismäßig, relativ
予定 (よてい): Plan, Programm, Erwartung, Vorhaben, Absicht, Voraussicht, Vorherbestimmung, vorher bestimmen, im Voraus festlegen, voraussehen, erwarten, vorsehen
治す (なおす): heilen, (1) reparieren, richten, ausbessern, (2) verbessern, berichtigen, korrigieren, (3) in Ordnung bringen, (4) zurecht machen, (5) ändern, verändern, (6) noch einmal machen, (7) konvertieren, umrechnen, (8) übersetzen, übertragen
変える (かえる): (1) ändern, verändern, abwandeln, (2) umwandeln, umformen, umgestalten, umbilden, wechseln, (3) reformieren, ergänzen, (4) sich verkleiden
留守 (るす): Rusu, (1) Abwesenheit, Ausbleiben, (2) Zuhausebleiben, Haushüten
背中 (せなか): (1) Rücken, (2) Rückseite
片付ける (かたづける): (1) aufräumen, in Ordnung bringen, ordnen, zurechtlegen, (2) wegräumen, wegschaffen, beiseite räumen, (3) erledigen, zu Ende machen, abschließen, fertig machen, fertig stellen, beendigen, (4) unter die Haube bringen (seine Tochter), (5) aus der Welt schaffen, abmurksen, beseitigen
船 (ふね): (1) Boot, Schiff, Wasserfahrzeug, (2) schiffförmiges Tablett für Sashimi, (3) Pferdetrog
あんな: so ein, solch ein, derartig, derlei
昼間 (ひるま): Tages…, Tag, tagsüber
歴史 (れきし): (1) Geschichte, Historie, Annalen, Chronik, (2) Tradition, historisch, geschichtlich
意見 (いけん): (1) Meinung, Ansicht, Auffassung, Idee, Standpunkt, Gesichtspunkt, (2) Rat, Ratschlag, Warnung, Hinweis, raten
叱る (しかる): schimpfen, schelten, rügen, zurechtweisen (um den anderen zur besseren Einsicht zu bringen)
泣く (なく): (1) weinen, flennen, greinen, schluchzen, heulen, (2) klagen, jammern, heulen, (3) etw. erleiden, leiden, betrübt sein, (4) sich einer unvernünftigen Forderung stellen müssen, (5) seinem Ruf nicht gerecht werden, etw. keine Ehre machen
申す (もうす): (1) sagen, erzählen, aussprechen, (2) heißen (besch.-höfl.)
手伝う (てつだう): (1) helfen, (2) beitragen
死 (し): (1) Tod, Sterben, (2) Out
壁 (かべ): (1) Mauer, Wand, (2) Barriere
勿論 (もちろん): (1) natürlich, selbstverständlich, selbstredend, gewiss, freilich, (2) zweifellos, ohne Zweifel, (3) ganz zu schweigen von …
お陰様で (おかげさまで): dank Ihrer freundlichen Unterstützung
工業 (こうぎょう): (1) Industrie, Fabrikindustrie, Technik, Gewerbe, (2) Handwerker, Arbeiter
産業 (さんぎょう): Industrie, Gewerbe, industriell, wirtschaftlich
娘 (むすめ): (1) Tochter, (2) junges Mädchen, junge Frau
濡れる (ぬれる): nass werden, durchnässt werden
苦い (にがい): (1) bitter, von sehr herbem Geschmack, (2) sauer, verstimmt, schlecht gelaunt, (3) bitter, schmerzlich, schlecht, schwer, außerordentlich mühsam
格好 (かっこう): (1) Form, Gestalt, Figur, (2) Haltung, Körperbau, Wuchs, (3) Aussehen, (4) Angepasstheit, gerade richtig, passend, angemessen, anständig, preiswert
場所 (ばしょ): (1) Platz, Stelle, Ort, (2) Position, (3) Sitzplatz, Platz, (4) Raum, Platz, (5) Turnier
動物園 (どうぶつえん): Tierpark, zoologischer Garten, Zoo
場合 (ばあい): Fall, Umstände, Gelegenheit, Situation, Verhältnisse
はっきり: klar, deutlich, offen, genau, sicher, bestimmt, entschieden, scharf, klar werden, sich klären, klar, deutlich, offen, genau, sicher, bestimmt, entschieden, scharf
経験 (けいけん): (1) Erfahrung, Erlebnis, (2) Erfahrenheit, Lebenserfahrung, Reife, Weltläufigkeit, (3) Versuch, Experiment, Test, (4) Erfahrung (als Form der Empirie), erfahren, Erfahrungen machen, erleben
棚 (たな): (1) Regal, Wandbrett, Büchergestell, (mn) Sims, (2) Spalier, Gitter, (3) Höhe, in der die Fische, die man fangen möchte schwimmen
盛ん (さかん): (1) lebhaft, belebt, gedeihend, blühend, erfolgreich, (2) populär, (3) aktiv, eifrig, (4) herzlich, enthusiastisch, (5) furios,heftig, heiß, (1) lebhaft, gedeihend, blühend, erfolgreich, (2) populär, (3) aktiv, eifrig
折れる (おれる): (1) brechen, zerbrechen, abgebrochen werden, (2) brechen, (3) sich falten lassen, zusammenklappbar sein, (4) jmdm. nachgeben, sich versöhnlich zeigen, (5) abbiegen
地理 (ちり): (1) Geographie, Erdkunde, (2) Raum, Gegend um …
お大事に (おだいじに): Gute Besserung!
パート: (1) ein Teil, (2) Stimme, (3) Teilzeitarbeit (Abk.), (4) Teilzeitarbeiter (Abk.)
小鳥 (ことり): kleiner Vogel, Vögelchen, Singvogel
飛行場 (ひこうじょう): Flugplatz, Flughafen
折る (おる): (1) brechen, zerbrechen, abbrechen, unterbrechen, (2) brechen, (3) falten, biegen, knicken
思う (おもう): (1) denken, (2) vermuten, (3) glauben, meinen, für etw. halten, (4) erwarten, (5) fühlen, (6) wünschen, hoffen, wollen, (7) vorhaben, beabsichtigen, (8) fürchten, (9) sich denken, sich vorstellen
スーツケース: Koffer
隅 (すみ): (1) Winkel, Ecke, (2) Peripherie, nicht im Zentrum gelegener Ort, (3) viereckiges Tablett, (4) Frisur für Jugendliche in der Edo-Zeit, bei der der Haaransatz nur wenig rasiert war, um gerade Linien zu bilden
小学校 (しょうがっこう): Grundschule,  (schweiz.)Primarschule
手袋 (てぶくろ): Handschuh, Fäustling
倒れる (たおれる): (1) umfallen, umkippen, hinfallen, (2) einstürzen, zusammenbrechen, (3) zugrunde gehen, untergehen, verfallen, gestürzt werden, (4) sterben, umkommen, ums Leben kommen, fallen, (5) erkranken, krank werden
儘 (まま): (1) wie es ist, wie die Dinge sind, (2) nach Belieben, wie es jmdm. beliebt, (3) sic, so steht es da, so lautet die Quelle
比べる (くらべる): (1) vergleichen, einen Vergleich anstellen, gegenüberstellen, entgegenhalten, kontrastieren, (2) wetteifern, sich messen
適当 (てきとう): (1) Eignung, Adäquanz, Angemessenheit, Passen, Entsprechen, (2) Halbherzigkeit, Unbestimmtheit, Vagheit, Lauheit, Mangel an Ernsthaftigkeit, Wischiwaschi, passend, angemessen, (1) angemessen, passend, adäquat, vernünftig, (2) nach Belieben, nach Gutdünken, wie man will
オーバー: (1) (2) (3) , übersteigen, übertreffen, überschreiten, über etw. hinausgehen, übertrieben, überzeichnet, übertrieben
例えば (たとえば): zum Beispiel, beispielsweise, um ein Beispiel anzuführen
ただ今 (ただいま): (1) zur Zeit, jetzt, gerade, (2) gerade eben, (3) Gleich, (4) Komme gleich, (5) Kommt gleich!, (6) Bin wieder daheim!
贈り物 (おくりもの): Geschenk, Gabe, Spende, Aufmerksamkeit
親 (おや): (1) Eltern, Vater und Mutter, (2) Geber, Bank (beim Spiel)
払う (はらう): (1) bezahlen, zahlen, begleichen, (2) abwischen, abstauben, abfegen, wegfegen, wegbürsten, ausbürsten, (3) vertreiben, beschwören, besprechen
コンピュータ: Computer
彼女 (かのじょ): (1) sie (3. Ps. fem. sing.), (2) Freundin, jmds. Liebste, ihr
旅館 (りょかん): Ryokan (Hotel im japanischen Stil)
線 (せん): (1) Linie, (2) Kabel, Draht, (3) Geleise, Gleis, Route, (4) die schlanke Linie, (5) Strahl, Lichtstrahl, (6) Niveau, (7) Parteilinie
揺れる (ゆれる): (1) schwanken, wackeln, schaukeln, zittern, beben, schwingen, rollen, schlingern, schlenkern, (2) unsicher sein, instabil sein, schwanken
お祝い (おいわい): Gratulation, Glückwunsch, Feier, Fest
水道 (すいどう): (1) Wasserleitung, Wasserversorgung, fließendes Wasser, Leitungswasser, (2) Kanal, Wasserstraße, Seestraße
下がる (さがる): (1) herabhängen, herunterhängen, (2) fallen, sinken, sich senken, (3) verlassen, weggehen, sich zurückziehen, (4) zurücktreten, rückwärts gehen, (5) verliehen werden, bewilligt werden, gewährt werden
殆ど (ほとんど): (1) fast ganz, fast alle, (2) fast, beinahe, (3) fast nie, selten (mit Verneinung)
ステレオ: Stereo, Stereoanlage
機会 (きかい): Gelegenheit, Chance, Opportunität
尋ねる (たずねる): (1) suchen, forschen, sich umsehen, (2) fragen, befragen, sich erkundigen
お宅 (おたく): (1) (2) , dein, Ihr
公務員 (こうむいん): (1) Beamter, Staatsbeamter, Bürokrat, Beamter im öffentlichen Dienst, (2) Bürokratie
確か (たしか): (1) richtig, fehlerlos, genau, korrekt, fest, klar, (2) verlässlich, gewiss, zweifellos, (3) sicher, bestimmt, festgesetzt, (4) wahrscheinlich, wohl, wenn ich mich recht entsinne, wenn ich nicht irre, (5) Festigkeit, (6) Gewissheit, (7) Fehlerlosigkeit, (8) Sicherheit, (9) Klarheit, Deutlichkeit, Verständlichkeit, Gewissheit, Korrektheit, Verlässlichkeit, sicher, unzweifelhaft, unbezweifelbar, verlässlich, authentisch
寝坊 (ねぼう): (1) Langschläfer, Spätaufsteher, (2) spätes Aufstehen, langes Schlafen, spät aufstehen
試験 (しけん): (1) Prüfung, Examen, (2) Test, Probe, Versuch, Experiment, (1) prüfen, eine Prüfung durchführen, (2) probieren, einen Test durchführen
席 (せき): (1) Sitz, Sitzplatz, Stuhl, Platz, (2) Raum, Platz, (3) Stelle, Position, Rang, Posten, (4) Kabarett, Varieté, (mn) Tingeltangel
景色 (けしき): Aussicht auf die Landschaft, Ausblick auf die Landschaft, landschaftliches Panorama, Landschaft, landschaftliche Kulisse, Szenerie
塵 (ごみ): Staub, Abfall, Abfall, Müll, Staub, Dreck
美しい (うつくしい): (1) schön, hübsch, bildhübsch, malerisch, entzückend, reizend, (2) edel gesinnt, von edler Gesinnung
競争 (きょうそう): (1) Wettbewerb, Wettkampf, Konkurrenz, Rivalität, Wettbewerbsausschreibung, Nebenbuhlerschaft, (2) Kampf ums Dasein, Überlebenswettbewerb, wetteifern, konkurrieren, im Wettbewerb stehen, rivalisieren, nacheifern, kompetitiv
指輪 (ゆびわ): Ring, Fingerring
君 (きみ): (1) du, (2) Herrscher, Souverän, (3) König
大抵 (たいてい): (1) meistens, in der Regel, in den meisten Fällen, gewöhnlich, normalerweise, ziemlich, (2) größtenteils, (3) vielleicht, wahrscheinlich, wohl, (4) nicht leicht, nicht einfach (mit Verneinung), die meisten …, fast alle …
先輩 (せんぱい): Senpai, Älterer, Senior (in Schule oder am Arbeitsplatz)
すっと: (1) gerade, (2) schnell, plötzlich, (3) frisch, erholt
お蔭 (おかげ): wohlwollende Unterstützung, Hilfsbereitschaft, Wohlwollen, Liebenswürdigkeit
阿弗利加 (アフリカ): Afrika
用 (よう): (1) Angelegenheit, Geschäft, Sache, Auftrag, Arbeit, (2) Gebrauch, (3) für …, …‑Gebrauch, (4) Notdurft,  (ugs.)Geschäft, (5) Unkosten, Ausgaben
市民 (しみん): (1) Bürger, Bürgerschaft, Bürgertum, (2) Stadtbewohner, Städter, Stadtleute
ケーキ: Kuchen, Torte, Biskuit, Backwerk
嘘 (うそ): (1) Lüge, Verlogenheit, Flunkerei, Unwahrheit, (2) Unrichtigkeit, Quatsch, (3) Erdichtung, Märchen, Falschmeldung, Fiktion
虫 (むし): (1) Insekt, Wurm, Gewürm, Würmchen, Made, Raupe, Larve, Holzwurm, Bücherwurm, Motte, Grille, (2) Schädling, Ungeziefer, (3) (Würmern zugeschriebene)Launenhaftigkeit bei Kindern, von Würmern verursachte Mürrischkeit, Nervosität, (4) Temperament, Gemütsart, Gemütsstimmung, (5) Leseratte, Bücherwurm, (6) jmd., der nach etwas verrückt ist, (7) Ahnung, Vorgefühl
亜細亜 (アジア): Asien, asiatisch
乾く (かわく): trocknen, austrocknen, trocken werden
決まる (きまる): (1) entschieden werden, bestimmt werden, festgesetzt werden, festgelegt werden, (2) bestimmt sein, regelmäßig sein, (3) auf jeden Fall so sein, ganz bestimmt so sein, klar sein, sowieso so sein (in der Form …ni kimatte iru), (4) eine Pose einnehmen und darin verharren, (5) die Form halten (z.B. eine Frisur), (6) eine Technik wie beabsichtigt durchführen, etw. durchziehen, (7) eine gute Beziehung zu einander herstellen (zwischen Mann und Frau)
さっき: vorhin, gerade, vor Kurzem
点く (つく): (1) brennen, angehen, Feuer fangen, (2) angezündet werden, angemacht werden
屹度 (きっと): (1) bestimmt, sicherlich, gewiss, zweifellos, auf jeden Fall, unbedingt, (2) ernst, scharf
踊る (おどる): tanzen
課長 (かちょう): (1) Leitung einer Abteilung, (2) Abteilungsleiter
真ん中 (まんなか): (1) Mitte, Zentrum, (2) halbe Strecke, halber Weg, Mitte
騒ぐ (さわぐ): (1) lärmen, Krach machen, Radau machen, toben, (2) viel Aufhebens machen, Theater machen um …, (3) aufgeregt sein, besorgt sein, (4) ausgelassen sein, toben, ein Saufgelage machen
髭 (ひげ): (1) Bart, Schnurrbart, Kinnbart, Vollbart, (2) Schnurrhaare, (3) Bartel (z.B. beim Wels), (4) Unruhfeder (einer Uhr)
特別 (とくべつ): besonders, speziell, Sonder…, Spezial…, Extra…, speziell, besonders, insbesondere, außergewöhnlich, ausnahmsweise, besonders, speziell, außergewöhnlich, außerordentlich
神社 (じんじゃ): Shintō-Schrein, Schrein
反対 (はんたい): (1) Gegenteil, Gegensatz, Umkehrung, (2) Opposition, Widerstand, Einspruch, Einwand, Widerspruch, Widerstreit, sich widersetzen, gegenüberstellen, einwenden, widersprechen, in die andere Richtung, im Gegenteil, (1) gegensätzlich, gegenteilig, entgegengesetzt, umgekehrt, (2) opponierend, ablehnend
引き出す (ひきだす): (1) herausziehen, herausführen, (2) abheben (Geld bei der Bank), (3) wecken (Fähigkeiten, Begeisterung etc.), (4) entlocken (eine Antwort)
科学 (かがく): (1) Wissenschaft, (2) (im engeren Sinne)Naturwissenschaft
お見舞い (おみまい): (1) Besuch, (2) Krankenbesuch, Erkundigung nach der Gesundheit, (3) Besuch bei jmdm. dem ein Unglück widerfahren ist, Erkundigung nach dem Befinden (bei jmdm., der krank ist, oder dem ein Unglück widerfahren ist), (4) Brief, um sich nach jmds. Gesundheit zu erkundigen, Brief, um sich nach jmds Ergehen nach einem Unglück zu erkundigen, (5) Geschenk für jmdn, dem ein Unglück widerfahren ist
其れに (それに): darüber hinaus, außerdem, dazu noch
入院 (にゅういん): Einlieferung ins Krankenhaus, Aufnahme ins Krankenhaus, ins Krankenhaus aufgenommen werden
為さる (なさる): tun, machen (höfl. für nasuなす und suruする)
別 (べつ): (1) Unterscheidung, Unterschied, (2) etw. Unterschiedliches, (3) etw. beiseite Gelassenes, (4) Extra, etw. Zusätzliches, anderer, anderer, unterschiedlich
そんなに: so, so sehr, soviel, besonders
息子 (むすこ): (1) Sohn, jmds. Junge, Filius, Junior, (2) Penis
丁寧 (ていねい): (1) Höflichkeit, Artigkeit, Zuvorkommenheit, (2) Sorgfalt, Sorgfältigkeit, Bedacht, Behutsamkeit, Genauigkeit, (1) höflich, artig, respektvoll, zuvorkommend, (2) gründlich, sorgfältig, bedächtig, genau, vorsichtig, (1) in höflicher Weise, (2) in sorgfältiger Weise
暮れる (くれる): (1) dämmern, dunkel werden, (2) sich neigen, zu Ende gehen, Nacht werden, Abend werden, (3) ratlos sein
筈 (はず): sollte, müsste, es ist zu erwarten, dass …, es ist zu vermuten, dass … (in der Konstruktion hazu de aru)
日記 (にっき): Tagebuch
申し上げる (もうしあげる): erzählen, sagen, bemerken, meinen (besch.-höfl.)
毛 (け): (1) Haar, Haare, (2) Behaarung, Wolle, Fell, Haar, (3) Feder, Flaum, Daune, (4) kaum, eine Spur
亜米利加 (アメリカ): (1) Amerika, der amerikanische Kontinent, (2) Vereinigte Staaten von Amerika, USA
歯医者 (はいしゃ): Zahnarzt, Dentist
プレゼント: Geschenk, schenken
心配 (しんぱい): (1) Angst, Bange, Sorge, Furcht, Befürchtung, Unruhe, Kummer, (2) Hilfe, Sorge, Unterstützung, (1) sich ängstigen, Angst haben, Furcht haben, sich sorgen, sich beunruhigen, (2) sich kümmern, besorgt, ängstlich
食料品 (しょくりょうひん): Lebensmittel, Nahrungsmittel, Esswaren
正しい (ただしい): (1) richtig, zutreffend, korrekt, (2) gerecht, ehrlich, aufrichtig, (3) gut, (4) vollständig, ganz, (5) gerade, aufrecht
受付 (うけつけ): (1) Rezeption, Auskunft, Information, (2) Empfang, Annahme
ソフト: (1) weich, (2) weicher Hut, Software (Abk.), weich
気 (き): (1) Charakter, Wesen, (2) Begeisterung, Eifer, Wille, (3) Interesse, Anteilnahme, (4) Gemüt, Gemütsbewegung, Gefühl, Emotion, (5) Bewusstsein, Besinnung, (6) Aufmerksamkeit, Teilnahme, Besorgnis, (7) Geisteskraft, Willenskraft, Lebenskraft, (8) Geruch, Geschmack, (9) Lebenskraft, Geist, (10) Atmosphäre, Stimmung, (11) Wille, Absicht, (12) Sitz der Lebenskraft, (13) formgebender Stoff
受ける (うける): (1) fangen, auffangen, (2) bekommen, erhalten, annehmen, (3) erleiden, bekommen, (4) für etw. halten, (5) ankommen, angenommen werden, erhalten (ein Pfand), übernehmen (Arbeit)
具合 (ぐあい): (1) Verfassung, Zustand, Angemessenheit, (2) Umstände, Stand, (3) Gesundheitszustand, (4) Art und Weise, Methode, (5) Verlauf einer Sache
教育 (きょういく): Erziehung, Bildung, Ausbildung, Training, Unterrichtung, Aufziehen, Kultivierung, erziehen, ausbilden, schulen, unterrichten, Unterricht geben, unterweisen, erzieherisch, pädagogisch
入学 (にゅうがく): (1) Eintritt in eine Schule (bzw. Uni), Aufnahme in eine Schule, Immatrikulation, (2) Schüler-Werden, Jünger-Werden, in eine Schule aufgenommen werden, in eine Schule eintreten, sich immatrikulieren
赤ん坊 (あかんぼう): (1) Säugling, Baby, Kleinkind, (2) ungeborenes Kind, (3) kindische Person
続ける (つづける): fortsetzen, fortfahren, fortführen
楽しみ (たのしみ): (1) Freude, Lust, Glück, Vergnügen, Hobby, (2) Vorfreude auf etw, zum Vergnügen, als Hobby
釣る (つる): (1) angeln, (2) anlocken, verleiten, verführen
卒業 (そつぎょう): (1) Schulabschluss, Universitätsabschluss, Absolvieren, Abgang, (2) Aufhören, Entwachsen, (3) Abschließen einer Unternehmung, (4) Ausscheiden (aus einer Gruppe), (1) die Schule absolvieren, sein Studium absolvieren, von der Schule abgehen, das Abschlussexamen bestehen, (2) entwachsen
安全 (あんぜん): (1) Sicherheit, Friedlichkeit, Ruhe, (2) Ungefährlichkeit, Gefahrlosigkeit, sicher, gefahrlos, zuverlässig, frei von Gefahr, in Sicherheit, außer Gefahr
お土産 (おみやげ): (1) Souvenir, Reisemitbringsel, Geschenk, (2) Wort bei einem Kinderspiel zum Abschied, (3) etw. Unangenehmes, das man von jmdm. bekommen hat (z.B. eine Geschlechtskrankheit) (Höflichkeitsform zu miyage土産)
恥ずかしい (はずかしい): (1) sich schämen, peinlich berührt sein, (2) schüchtern, verlegen, scheu, (3) beschämend, schändlich
女性 (じょせい): (1) Frau, weibliche Person, weibliches Wesen, (2) Weiblichkeit, weibliches Geschlecht, (3) Femininum, Frau, Dame, schönes Geschlecht, weiblich
経済 (けいざい): (1) Wirtschaft, Ökonomie, (2) wirtschaftliche Lage, (3) (urspr. Bed.)Verwaltung der Welt und Errettung des Volkes vor Leid, (4) Finanzen, (5) Sparsamkeit, Wirtschaftlichkeit
点 (てん): (1) Punkt, Tupfen, Fleck, (2) Punkt, Zensur, (3) Punkt, Matrixpunkt, (4) Tropfenmuster, (5) Punkt, Treffer, Tor, (6) Dezimalpunkt, Dezimalkomma, (7) Punkt, (8) japanisches Komma, (9) japanischer Betonungspunkt (neben den Zeichen), (10) Punkt, Diskussionspunkt, (11) Hinsicht, Beziehung, (12) Standpunkt, Gesichtspunkt
終わり (おわり): Ende, Schluss, Abschluss, Ausgang
交通 (こうつう): (1) Kommen und Gehen (von Personen und Fahrzeugen), (2) Verkehr (von Personen, Waren und Nachrichten), Transport, Beförderung, (3) Personenverkehr, Personentransport, (4) Güterverkehr, Gütertransport, Warenverkehr, (5) Nachrichtenverkehr, Kommunikation, verkehren, Kontakt haben
鏡 (かがみ): (1) Spiegel, (2) Kagami・mochi, flaches, rundes Mochi, (3) Deckel (eines Sakefasses), (4) Deckblatt für verwaltungsinterne Papiere (mit z.B. Adresse, Titel, Datum, Verfassern etc.), (5) Kagami・mono (japan. Geschichtswerke, die das Wort kagami im Titel tragen; Abk.)
一生懸命 (いっしょうけんめい): (1) mit ganzer Kraft, mit ganzer Energie, mit äußerster Anstrengung, (2) so gut man kann, mit aller Kraft
矢っ張り (やっぱり): (1) wie gesagt, wie erwartet, (2) auch, ebenfalls, genauso, (3) noch, noch immer, wieder, tatsächlich, doch, (4) schließlich, am Ende
支度 (したく): (1) Vorbereitung, Vorkehrung, (2) Vorbereiten von Essen, (3) Ausrüstung, Ausstattung, (4) Ankleiden (zum Ausgehen), sich vorbereiten, Vorbereitungen treffen, Vorkehrungen treffen, sich anschicken, Anstalten machen, sich präparieren
ビル: Gebäude, Bürogebäude, Geschäftsgebäude, Hochhaus, Max Bill (schweizer. Architekt, Maler, Designer u. Plastiker; 1908–1994)
代 (だい): (1) Generation, Zeit, Herrschaft, (2) Jahrzehnt, (3) Erdzeitalter, (4) Stellvertreter, Ersatz, (5) …‑Gebühr, …‑Ausgaben
辞典 (じてん): Wörterbuch (die übliche Lesung ist jiten; die Lesung kotoba・ten wird verwendet, um von Zeichen‑ bzw. Konversationslexikon abzugrenzen), Wörterbuch
どんどん: (1) schnell, geschwind, rapide, rasch, flott, (2) in Mengen, haufenweise, ständig, (3) stark, ungehemmt, heftig, (4) dreist, offenherzig, hemmungslos, (5) nur so, (6) bummern, Bumbum
褒める (ほめる): loben, preisen
お祭り (おまつり): (1) Schreinfest, (2) Fest, Feier
すっかり: (1) ganz, gänzlich, alles, restlos, (2) völlig, vollkommen
可笑しい (おかしい): (1) lustig, komisch, (2) lächerlich, (3) merkwürdig, seltsam, (4) verdächtig, (5) falsch, verkehrt
表 (おもて): (1) Oberfläche, Vorderseite, Front, Fassade, Oberseite, rechte Seite, (2) Außenseite, draußen, im Freien, (3) Straße, (4) Anfang, erste Hälfte
特急 (とっきゅう): Schnellzug, Expresszug (Abk.)
眠る (ねむる): (1) schlafen, schlummern, einschlafen, (2) entschlafen, sterben, (3) ertraglos liegen, nutzlos liegen
十分 (じゅうぶん): ausreichend, genügend, vollständig, ganz, hinlänglich, Zehntel, ausreichend, genügend, vollständig, ganz, hinlänglich, durch Zehn teilen, in genügender Weise, genügend, ausreichend, reichlich, Zehntel
優しい (やさしい): (1) freundlich, nett, (2) sanft, milde, fein, zart, anmutig, (3) gutmütig, gütig
張る (はる): kleben, ankleben, aufkleben, (1) aufspannen, aufstellen (Zelt), aufhängen (Vorhänge od. Tapeten), aufstellen (Netz), spannen (Seil), aufziehen (Segel), ausbreiten, auslegen, verlegen (Kacheln od. Parkett), bedecken, (2) anspannen, eine steife Haltung annehmen, (3) eine Ohrfeige geben, (4) teuer sein, (5) gespannt sein, (6) sich ein Ansehen geben, (7) zufrieren
空気 (くうき): (1) Luft, Atemluft, Erdatmosphäre, (2) Atmosphäre (eines Ortes oder in einer Gruppe), Klima
忘れ物 (わすれもの): (1) Liegengelassenes, Vergessenes, Fundsache, (2) Liegenlassen, Vergessen
湯 (ゆ): (1) heißes Wasser, warmes Wasser, (2) heißes Bad, (3) heiße Quelle
眠い (ねむい): müde, schläfrig
専門 (せんもん): Fach, Fachgebiet, Hauptfach, Beruf, fachlich, speziell
看護婦 (かんごふ): Krankenschwester, Krankenpflegerin
エスカレーター: Rolltreppe
工場 (こうじょう): (1) Fabrik, Fabrikanlage, Werk, Werkstatt, (2) Fabrikgebäude, Werkstatt, Fertigungshalle, Fabrik
注射 (ちゅうしゃ): (1) Injektion, Spritze, Impfung, (2) Begießen mit Wasser, (3) Richten der Aufmerksamkeit auf etw., injizieren, eine Spritze geben
値段 (ねだん): Preis, Kosten
熱 (ねつ): (1) Wärme, Hitze, (2) Fieber, Körpertemperatur, (3) Enthusiasmus, Eifer, (4) Enthusiasmus, Manie
故障 (こしょう): (1) Nichtfunktionieren, Nichtlaufen, (2) Fehler, Mangel, Defekt, Schaden, Beschädigung, (3) Störung, Schwierigkeit, Problem, Hindernis, Hemmung, Behinderung, Haken, Unglück, (4) Einspruch, Widerspruch, Einwand, Protest, defekt sein, kaputt sein, eine Panne haben, gestört sein
様 (さま): Form, Zustand, Situation, Lage, Umstand
拾う (ひろう): (1) aufheben, finden, aufsammeln, (2) auswählen, auflesen
素晴らしい (すばらしい): (1) wunderbar, ausgezeichnet, prächtig, hervorragend, herrlich, fabelhaft, großartig, prima, (2) verblüffend, furchtbar, fürchterlich
指 (ゆび): Finger, Zehe, Digitus
生産 (せいさん): Produktion, Herstellung, Erzeugnis, Gütererzeugung, produzieren, herstellen, erzeugen
両方 (りょうほう): (1) beide, beide Seiten, beides, alle beide, (2) keiner, keiner von beiden (bei Verneinung), beide
上手い (うまい): (1) wohlschmeckend, lecker, gut, schmackhaft, köstlich, delikat (Schreibung 美味い nur in dieser Bed.), (2) geschickt, begabt, geübt, gewandt, tüchtig, schön, passend, gut in … (die Schreibungen 上手い und 巧い nur für diese Bed.), (3) gewinnbringend, günstig
そんな: (1) so ein, solch ein, derartig, (2) Betonung gegenüber etw., das der Gesprächspartner gesagt hat
西洋 (せいよう): Abendland, Okzident, Europa, Westen, westliche Welt, Europa und die USA, westlich, okzidental
最近 (さいきん): (1) letzt, jüngst, neuest, (2) vor kurzem, neulich, in letzter Zeit, jüngst, neuest, letzt
味 (あじ): (1) Geschmack, Aroma, Würze, (2) guter Geschmack, gute Küche, (3) Gefühl für etw, Erfahrung, (4) Geschmack, Kunstverständnis
決める (きめる): (1) festlegen (Regeln, Grundsätze), (2) einen Entschluss fassen, sich entschließen, beschließen, zum Entschluss kommen, sich entscheiden für …, (3) auswählen, wählen, (4) fällen (ein Urteil), festsetzen, fixieren, (5) bestimmen, (6) in einer Pose verharren, (7) halten, geordnet bleiben, (8) eine Technik ausführen lassen, (9) die Arme des Gegners blockieren, (10) verantwortlich machen, (11) essen und trinken
計画 (けいかく): Plan, Planung, Projekt, Entwurf, Absicht, planen, entwerfen, einen Plan machen, einen Entwurf machen
見つける (みつける): (1) finden, ausfindig machen, ausmachen, herausfinden, entdecken, stoßen auf, (2) bemerken, ertappen, erwischen, (3) suchen, (4) vertraut werden, sich gewöhnen
社長 (しゃちょう): Firmenpräsident, Direktor, Chef, Firmenchef, Boss
葉 (は): Blatt (einer Pflanze), Laubblatt, Nadelblatt
布団 (ふとん): Futon, japanisches Bettzeug
不便 (ふべん): (1) Unbequemlichkeit, Unannehmlichkeit, Ungelegenheit, (2) Nachteil, unbequem, unpraktisch, ungelegen, unhandlich
難い (かたい): schwierig
参る (まいる): (1) gehen, kommen, besuchen, aufsuchen (besch.-höfl. Form für kuru 来る und iku 行く), (2) einen Tempel besuchen, einen Schrein besuchen, (3) niedergeschlagen werden, besiegt werden, verlieren, (4) bezaubert werden, verwirrt werden, aus der Fassung gebracht werden
彼ら (かれら): sie (Personalpron. 3. Ps. pl.), ihnen, ihr
紹介 (しょうかい): Vorstellung, Empfehlung, Einführung, vorstellen, bekannt machen, einführen
運転 (うんてん): (1) Fahren, Steuern, Lenkung, Steuerung, (2) Bedienen, Betrieb, Gang, Tätigkeit, (1) in Betrieb setzen, in Gang bringen, (2) fahren, steuern, lenken
空く (すく): (1) leer sein, nicht voll sein, (2) nicht besetzt sein, (3) sich gut fühlen
滑る (すべる): (1) rutschen, schlittern, gleiten, eislaufen, (2) wegrutschen, ausrutschen, ausgleiten, (3) sich versprechen, sich verschreiben, (4) durch eine Prüfung fallen, bei einer Prüfung scheitern, (5) wegrutschen, (6) abdanken, (7) floppen, nicht ankommen (mit einem Witz)
泥棒 (どろぼう): (1) Dieb, Räuber, Einbrecher, (2) Diebstahl, Raub, Einbruch, stehlen, klauen
味噌 (みそ): Miso (Paste aus vergorenen Sojabohnen)
大学生 (だいがくせい): Student, Hochschüler
星 (ほし): Hoshi, (1) Stern, (2) das Schwarze (einer Zielscheibe), (3) Sternchen, Asterisk, (4) Fleck, (5) Verdächtiger, (6) Verbrecher, Täter (Polizeijargon), (7) Schicksal
宜しい (よろしい): (1) gut, richtig, (2) in Ordnung
ご主人 (ごしゅじん): Ehemann (ehrerbietig-höfl. Bez. für jmds. anderen Ehemann)
葡萄 (ぶどう): Traube, Weintraube, Rebe, Vitis vinifera
下さる (くださる): (1) geben, schenken, spenden, gewähren, verleihen, (2) etw. für jmdn. tun, so freundlich sein, … zu tun
用事 (ようじ): (1) Angelegenheit, Arbeit, Geschäft, (2) Besorgung, Erledigung, (3) Notdurft,  (ugs.)Geschäft, (4) Pausieren (der Freudenmädchen aufgrund körperlicher Beschwerden od. privater Angelegenheiten; im Freudenviertel Fukagawa in Edo verwendeter Begriff)
再来週 (さらいしゅう): übernächste Woche
内 (うち): (1) (2) , innen, drinnen, innerhalb, unser
力 (ちから): (1) Kraft, Körperkraft, Geisteskraft, (2) Macht, Gewalt, (3) Autorität, Einfluss, Gewicht, (4) Fähigkeit, Können, (5) Mittel, Ressourcen, (6) Mut
海岸 (かいがん): Meeresküste, Seeküste, Küste, Strand, Gestade, an die Küste
花見 (はなみ): Blütenschau, Kirschblütenschau, Betrachten der Kirschblüten (meist verbunden mit Essen und Trinken unter den blühenden Bäumen)
品物 (しなもの): Ware, Waren, Artikel, Erzeugnisse
伺う (うかがう): (1) besuchen, aufsuchen, zu jmdm. kommen, (2) sich erkundigen, fragen, anfragen, (3) erfahren, hören
今度 (こんど): (1) dieses Mal, diesmal, jetzt, (2) nächstes Mal, bald, nächstens, (3) letztes Mal, letztens, kürzlich, jüngst, neulich
水泳 (すいえい): Schwimmen, Baden, schwimmen
投げる (なげる): (1) werfen, schmeißen, (2) aufgeben, verwerfen
通う (かよう): (1) regelmäßig gehen, regelmäßig fahren, verkehren zwischen, hin und her gehen, (2) besuchen, gehen zu …, (3) zirkulieren, umlaufen, (4) pulsieren, atmen, lebendig sein, innerlich verbunden sein
天気予報 (てんきよほう): Wettervorhersage, Wetterprognose
気持ち (きもち): (1) Stimmung, Gefühl, Befinden, (2) Gemüt, (3) körperliches Befinden, (4) Haltung gegenüber einer Sache, (5) (besch.-höfl. für) die eigene Aufmerksamkeit gegenüber jmdm. anderen, (6) (adverbial) ein bisschen …, ein wenig …, eine Idee …
用意 (ようい): Vorbereitung, Bereitschaft, Vorrat, Ausrüstung, Vorsicht, vorbereiten, Vorbereitungen treffen, sich vorbereiten
すると: dann, darauf, also
タイプ: (1) Typ, (2) Schreibmaschine (Abk.), tippen, Schreibmaschine schreiben
事務所 (じむしょ): Büro, Office, Kontor
聞こえる (きこえる): (1) hören können, hörbar, vernehmbar sein, hören, vernehmen, (2) sich anhören, klingen wie, scheinen, (3) berühmt sein, namhaft sein, bekannt sein, in aller Munde sein
着物 (きもの): (1) Kimono, japanische Kleidung, (2) Kleidung, Kleider
坂 (さか): Abhang, Steigung, Abstieg, Böschung, Hügel
喧嘩 (けんか): (1) Streit, Krach, Zank, Hader, (2) Rauferei, Prügelei, Handgemenge, (1) streiten zanken, Krach haben, hadern, (2) raufen, sich prügeln, sich schlagen, sich in den Haaren liegen
飾る (かざる): (1) schmücken, verzieren, dekorieren, garnieren, (2) sich aufputzen, sich herausputzen, sich ausstaffieren, (3) ausstellen, (4) ausschmücken (z.B. eine Rede)
知らせる (しらせる): (1) mitteilen, benachrichtigen, in Kenntnis setzen, Kunde geben, melden, wissen lassen, (2) bekannt geben, bekannt machen, kundgeben, kundtun, veröffentlichen
畳 (たたみ): Tatami
建てる (たてる): (1) bauen, erbauen, errichten (z.B. ein Gebäude), (2) gründen, begründen, aufbauen (eine Organisation, ein Land etc.)
金持ち (かねもち): Reicher, reiche Person, Wohlhabender, Millionär, Milliardär
ご馳走 (ごちそう): (1) Festessen, Festmahl, (2) Leckerbissen, Leckerei, Köstlichkeit, (3) Bewirtung, Beköstigung, Verköstigung, (4) Gastfreundschaft, einladen (zum Essen), jmdm. ein Essen ausgeben, freihalten, bewirten, ein Gastmahl geben
住所 (じゅうしょ): Wohnort, Wohnsitz, Adresse, Anschrift, Domizil
止める (とめる): (1) anhalten, zum Stehen bringen, (2) unterbrechen, abstellen, ausschalten, (3) verbieten, abbringen, abhalten, aufhalten, (4) befestigen, (1) anhalten, stoppen, (2) befestigen, festmachen, (3) abhalten, (4) aufhalten, (5) hinterlassen, zurücklassen, (6) festhalten, einschließen
差し上げる (さしあげる): (1) geben, schenken, anbieten, (2) aufheben, hochheben, erheben (besch.-höfl. Verb für ataeru 与える und yaru 遣る)
全然 (ぜんぜん): (1) überhaupt nicht, nicht das geringste, (2) vollkommen, total
頂く (いただく): (1) erhalten, bekommen, (2) aufsetzen, tragen, (3) essen, trinken, (4) etw. von jmdm. getan bekommen
林 (はやし): Hayashi, Wald, Wäldchen, Forst
ピアノ: (1) Klavier, Flügel, Pianoforte, Piano, (2) piano
止む (やむ): aufhören, zu Ende sein, zu Ende gehen, sterben, umkommen
慣れる (なれる): (1) sich gewöhnen, sich akklimatisieren, (2) sich eine Fähigkeit aneignen, Geschicklichkeit gewinnen, einem zur Gewohnheit werden, (3) vertraut werden, (4) zahm werden, (5) sich anpassen, (6) (nach Renyō・kei oder Substantiven) an … gewohnt sein, (7) vertraut werden, sich öffnen, (8) abgetragen werden, zahm werden, zahm sein
字 (じ): (1) Schriftzeichen, Buchstabe, Letter, (2) Handschrift
失礼 (しつれい): Unhöflichkeit, Grobheit, Rohheit, Unfreundlichkeit, Unverschämtheit, Unbildung, unhöflich, grob, ungebildet, roh, unfreundlich, liebesverlassen, gebrochenen Herzens
途中 (とちゅう): (1) unterwegs, auf dem Weg, auf halbem Wege, (2) Hälfte (der Zeit)
寂しい (さびしい): (1) einsam, öde, verlassen, allein, (2) ungenügend, (1) einsam, öde, verlassen, allein, traurig, (2) fehlend, ungenügend, (3) still, ruhig, verlassen
一杯 (いっぱい): (1) (2) (3) , voll, überfüllt
研究 (けんきゅう): Forschung, Erforschung, Untersuchung, Studium, (1) untersuchen, arbeiten über …, erforschen, forschen, ein Studium treiben, (2) sich etw. überlegen, erwägen
研究室 (けんきゅうしつ): Studienraum, Büro, Institut, Seminar, Labor, Laboratorium
雲 (くも): (1) Wolke, (2) etw. Wolkenartiges, (3) etw. weit Entferntes, (4) etw. Unklares, (5) etw., das einen bedrückt, (6) Rauchwolke, (7) Wolkenwappen
足りる (たりる): reichen, ausreichen, genug sein, genügen, wert sein, zufrieden sein
必ず (かならず): gewiss, sicher, ohne Zweifel, unbedingt, auf jeden Fall, bestimmt
美術館 (びじゅつかん): Kunstmuseum, Kunsthalle, Galerie
月 (つき): (1) Mond, Erdmond, Luna, (2) Mond, Satellit, Trabant, (3) Monat (als Kalendereinheit), (4) Monat, 30 Tage, (5) Mondlicht, (6) gelegener Zeitpunkt, Gelegenheit, (7) (erwarteter)Geburtsmonat, (8) Mondwappen, (9) Menstruation, Regel
構う (かまう): (1) sich kümmern, für jmdn. sorgen, (2) sich einmischen, sich abgeben, sich einlassen, (3) jmdm. Gesellschaft leisten, gastfreundlich sein, jmdn. bewirten, (4) ausmachen, behandeln
枝 (えだ): Ast, Zweig, Gerte, Reis, Rute, Spross
式 (しき): (1) Feier, Feierlichkeit (insbes. Hochzeitsfeier), (2) Zeremonie, Ritus, (3) Stil, Modell, Typ, Art, Methode, (4) Formel, (5) Ausdruck, (6) Gleichung, Ungleichung
国際 (こくさい): international, zwischenstaatlich
会 (かい): (1) Treffen, Versammlung, Zusammenkunft, Besprechung, Konferenz, Tagung, Sitzung, Party, (2) Gesellschaft, Verein, Verband, Klub
割れる (われる): (1) zerbrechen, springen, bersten, platzen, einen Riss bekommen, (2) sich spalten, (3) entdecken, identifiziert werden, erkennen, (4) verzerrt werden (Ton)
アルコール: Alkohol, alkoholisch
楽しむ (たのしむ): (1) sich freuen, zufrieden sein, genießen, (2) sich vergnügen, sich amüsieren, sich ergötzen, (3) sich auf etw. freuen, auf etw. hoffen, (4) sich ausruhen, sich erholen, (5) reich werden, Wohlstand erwerben
スーツ: (1) Anzug, (2) Kostüm, Jacke und Rock
逃げる (にげる): (1) fliehen, weglaufen, entkommen, ausreißen, sich aus dem Staub machen, (2) sich drücken, sich entziehen, einen Rückzieher machen, von etw. zurücktreten
田舎 (いなか): (1) Land (im Gegensatz zur Stadt), ländliches Gebiet, Provinz, (2) Heimat, Herkunftsort, ländlich, vom Lande, provinziell, heimisch
気分 (きぶん): (1) Stimmung, Gemütsstimmung, Verfassung, Laune, (2) körperliche Verfassung, Befinden, (3) Atmosphäre, allgemeine Stimmung, allgemeiner Trend
随分 (ずいぶん): ziemlich, wirklich, recht, ganz, sehr
汚れる (よごれる): (1) schmutzig werden, schmutzig sein, verunreinigt sein (im Gegensatz zum Homographen kegareru meist im konkreten Sinn verwendet), (2) unrechtmäßig sein, schmutzig sein
特に (とくに): besonders, speziell
簡単 (かんたん): Einfachheit, Schlichtheit, Unkompliziertheit, Bündigkeit, Kürze, einfach, bündig, leicht, kurz, schlicht, in Kürze, in kurzen Worten, mit wenig Worten, ohne viel Worte
降り出す (ふりだす): anfangen zu fallen (Regen, Schnee)
将来 (しょうらい): Zukunft, kommende Zeit, Aussicht, in Zukunft
酷い (ひどい): (1) schlimm, furchtbar, schrecklich, grausam, entsetzlich, (2) hart, heftig, schwer, stark, gewaltsam, (3) maßlos, unvernünftig, wahnsinnig
御座います (ございます): es gibt, sein, haben (höflich)
成るべく (なるべく): (1) möglichst, (2) wenn möglich, wo möglich
植える (うえる): (1) pflanzen, anpflanzen, (2) setzen (Text)
役に立つ (やくにたつ): nützlich sein, hilfreich sein
深い (ふかい): (1) tief, (2) tiefgehend, gründlich, (3) dicht, dick, dunkel, (4) innig, intim, vertraut, (5) spät,  (weit) fortgeschritten
説明 (せつめい): Erklärung, Erläuterung, Darlegung, erklären, erläutern, darlegen, explikativ
男性 (だんせい): (1) männliches Geschlecht, Mann, (2) Maskulinum, männlich
翻訳 (ほんやく): (1) Übersetzung, (2) Translation, (3) Kompilierung, übersetzen
焼く (やく): (1) etw. verbrennen, ins Feuer werfen, (2) braten, rösten, backen, toasten, (3) braun werden, Teint bekommen, (4) brennen (Keramik), (5) Abzüge machen, (6) auspinseln, (7) sich verzehren nach etw, (8) brennen (eine CD)
遠慮 (えんりょ): (1) Zurückhaltung, Beherrschung, Bescheidenheit, Rücksicht, Reserve, (2) Verzicht, Ablehnung, (3) Ausgangs‑ bzw. Eingangsverbot (in der Edo-Zeit als Strafe gegen Mönche und Samurai), (4) Weitsicht, Voraussicht, Besonnenheit, Vorsicht, (1) sich zurückhalten, sich enthalten, Umstände machen, (2) Rücksicht nehmen, (3) sich zurückziehen, abtreten, zurücktreten
いらっしゃる: (1) kommen, (2) gehen, (3) sein
台風 (たいふう): Taifun
喉 (のど): (1) Hals, Kehle, Gurgel, (2) Stimme, (3) Schlucht, Enge, Hals, Kehle, Gurgel
この間 (このあいだ): vor kurzem, kürzlich, jüngst, neulich, letztes Mal, währenddessen
億 (おく): einhundert Millionen, 100.000.000
火事 (かじ): Brand, Brandunglück, Feuer, Feuersbrunst
心 (こころ): (1) Herz, Gemüt, Seele, Geist, Gefühl, Sinn, (2) Antwort, Lösung, Sinn, Bedeutung
沸かす (わかす): (1) heiß machen, kochen, zum Kochen bringen, sieden, (2) aufregen, begeistern, erregen
サンドイッチ: Sandwich
アルバイト: Job, Nebenjob, Nebenverdienst, Teilzeitarbeit, Albit, Natronfeldspat, jobben, nebenbei arbeiten, Teilzeit arbeiten
積もり (つもり): Absicht, Vorhaben, Vorsatz, Plan, Erwartung, Hoffnung, Voraussicht
床屋 (とこや): (1) Barbier (in der Edo-Zeit), (2) Friseur, Haarschneider, (3) Friseurladen, Haarschneidesalon
通り (とおり): (1) Straße, Weg, Gang, Straßenverkehr, (2) Sorte, Art, (3) Weg, Methode, Weise, Art und Weise, wie, (4) Gunst, Ruf, (5) Art und Weise, (6) ungefähr, im Großen und Ganzen, (7) so, wie, gemäß
太る (ふとる): (1) dick werden, fett werden, zunehmen, (2) reich werden
成程 (なるほど): in der Tat!, genau!, aha!, wirklich wahr!, so ist das also!, ich verstehe!, ach nein!
案内 (あんない): (1) Information, Auskunft, (2) Führung, Begleitung, (3) Führer, (4) detaillierte Information, (5) tiefergehendes Wissen, (6) Anmeldung, (7) Inhalt eines Textes oder Textentwurfes (insbes. zu Präzedenzfällen und internen Regeln einer Behörde), (8) Anfrage zu Details und Umständen, (1) jmdn. führen, herum führen, begleiten, geleiten, leiten, (2) zeigen (z.B. die Stadt), (3) informieren, benachrichtigen
思い出す (おもいだす): (1) sich erinnern, sich entsinnen, wieder einfallen, noch wissen, zurückdenken, sich besinnen, (2) auf etw. kommen, es fällt einem etw. ein
回る (まわる): (1) kreisen, sich drehen, rotieren, wirbeln, (2) umlaufen, zirkulieren, herumgehen, (3) abbiegen, (4) an der Reihe sein, (5) die Runde machen, um sich greifen, von einem Ort zum anderen gehen, eine Rundreise machen
斯う (こう): so, auf diese Weise, in dieser Weise, wie dies, wie folgt
アクセサリー: (1) Accessoire, Schmuck, Zubehör, (2) Zubehör, (3) Peripherie
会議室 (かいぎしつ): Konferenzraum, Konferenzzimmer, Besprechungszimmer
近所 (きんじょ): (1) Nähe (des eigenen Hauses), Nachbarschaft, nahe Umgebung, (2) nahe gelegenes Haus, (3) nähere Umgebung des Feudalherren, in der Nähe, in der Nachbarschaft, nah, nachbarschaftlich, benachbart, angrenzend, nicht weit
裏 (うら): (1) Rückseite, Kehrseite, innere Seite, Hinterseite, (2) Futter, (3) verborgene Seite, verborgene Bedeutung, (4) letzte Hälfte eines Innings, (5) Sohle
消しゴム (けしゴム): Radiergummi
玩具 (おもちゃ): (1) Spielzeug, Spielsachen, Spielwaren, (2) Kleinigkeit, Bagatelle, (3) Zeitvertreib, Spielzeug, Spielzeug
暖房 (だんぼう): (1) Heizung, (2) Heizen, heizen
生きる (いきる): Ikiru – Einmal wirklich leben (Film von Kurosawa Akira; 1952), (1) leben, lebendig sein, belebt sein, (2) sein Leben verbringen, sein Leben zubringen (auch um den entsprechenden Ort und die Zeit anzugeben; in der Form …ni ikiru od. …o ikiru), (3) sein ganzes Leben verbringen, (4) seinen Lebenswert in etw. sehen, für etw. leben (in der Form …ni ikiru), (5) fortleben (z.B. das Andenken oder der Einfluss eines Toten), (6) zur Entfaltung kommen, seine Wirkung zeigen, (7) nicht mit der Ablage eines gegnerischen Steines eingekreist werden können, (8) nicht Out sein, sondern an einer Base sein
怪我 (けが): (1) Verletzung, Wunde, Verwundung, (2) Glücksfall, (3) Fehler, Versehen, (1) sich verletzen, (2) verletzt werden, verwundet werden
汽車 (きしゃ): (1) von einer Dampflok gezogener Zug, (2) (allg.)Eisenbahn, Zug
祈る (いのる): (1) beten, ein Gebet halten, ein Gebet verrichten, anrufen, flehen, (2) wünschen, hoffen
複雑 (ふくざつ): (1) Verwicklung, Kompliziertheit, Komplexität, Schwierigkeit, Umständlichkeit, (2) kompliziert, kompliziert, komplex, verwickelt, verzwickt, beschwerlich, umständlich
スクリーン: (1) Bildschirm, (2) Filmleinwand, Leinwand, (3) Film, Filmwelt
込む (こむ): (1) überfüllt sein, sich drängen, (2) hereinkommen, hineintun, (3) vollständig …
上がる (あがる): (1) steigen, aufsteigen, aufgehen, sich erhöhen, erhöht werden, ansteigen, (2) hinaufgehen, hochgehen, hochfahren, hochsteigen, (3) aus dem Wasser kommen, an Land gehen, (4) eintreten, ins Haus kommen, (5) aufrücken, fortschreiten, (6) in einer Villa in den Dienst treten, (7) in eine Schule eintreten, in eine Schule vorrücken, (8) heben, (9) hissen, (10) steigen lassen, (11) abbrennen (ein Feuerwerk), aufziehen (einen Vorhang), (12) opfern, vor den Altar stellen, (13) erscheinen, auftauchen, entdeckt werden, (14) ermittelt werden, gefasst werden, (15) sich erhöhen, steigen (Miete, Zinsen etc.), (16) beenden, vollenden, (17) enden, zu Ende gehen, aufhören, (18) betragen, nicht teurer sein als …, (19) zu fallen aufhören (Regen, Schnee), (20) sich zu bewegen aufhören, (21) beenden (ein Spiel), (22) sich in den Norden begeben, (23) essen, trinken (ehrerb.-höflich), (24) aufgeregt sein, die Fassung verlieren, (25) besuchen, aufsuchen (besch.-höfl.), (26) zitiert werden, angeführt werden, (1) gezeigt werden, sichtbar werden, (2) festgenommen werden, (3) berühmt werden, sich einen Namen machen, (1) emporsteigen, hoch gehen, (2) frittiert sein
足す (たす): (1) hinzufügen, addieren, (2) dazutun, ausgleichen
今夜 (こんや): heute abend, heute nacht, diese Nacht
引き出し (ひきだし): (1) Schublade, Schubfach, (2) Abheben (Geld von einem Konto)
立てる (たてる): (1) aufstellen, errichten, aufrichten, (2) zusammenstellen, (3) gründen, stiften, ins Leben rufen, (4) entwerfen, konzipieren, (5) emporkommen, es weit bringen, (6) große Dienste leisten, (7) verbreiten, in Umlauf bringen, (8) jmdm. gegenüber respektvoll sein, jmdn. mit Respekt behandeln
一度 (いちど): (1) ein Mal, (2) ein Grad, 1°, (3) Prime, (4) einmal, bei einer Gelegenheit, einmal
サラダ: Salat
お嬢さん (おじょうさん): (1) Ihre Tochter, (2) Mädchen, junge Dame
部長 (ぶちょう): Abteilungsleiter, Hauptabteilungsleiter, Chef einer Abteilung
運転手 (うんてんしゅ): (1) Fahrer, Chauffeur, (2) Kraftfahrer, (3) Lokführer, Führer, (4) Maschinist, Anlagenfahrer
包む (くるむ): einwickeln, zudecken, einhüllen, (1) einwickeln, einschlagen, einhüllen, verpacken, (2) verhüllen, verdecken
鳴る (なる): (1) ertönen, tönen, erklingen, klingen, heulen, quietschen, dröhnen, klingeln, (2) berühmt werden
や: und, oder, und so weiter
出発 (しゅっぱつ): Abfahrt, Abreise, Abflug, Abmarsch, abfahren, abreisen, starten, sich auf den Weg machen
帰り (かえり): Heimkehr, Heimreise, Rückkehr, Rückreise, Rückweg, Rückfahrt
彼 (かれ): (1) er (mask. Sing), (2) fester Freund, Liebhaber, ihm, sein
育てる (そだてる): (1) aufziehen, züchten, pflegen, großziehen, (2) erziehen, ausbilden, (3) zu etw. anstiften, aufhetzen
利用 (りよう): (1) Benutzung, Ausnutzung, Gebrauch, Auswertung, Nutzanwendung, Verwertung, (2) Ausbeutung, Ausnutzung, benutzen, ausnutzen, verwenden, verwerten, auswerten, nutzbar machen
負ける (まける): (1) unterliegen, verlieren, besiegt werden, (2) nachstehen, (3) nachgeben, (4) Rabatt geben, mit dem Preis herunter gehen
謝る (あやまる): (1) sich entschuldigen, jmdn. um Entschuldigung bitten, (2) sich entschuldigen lassen, ablehnen
社会 (しゃかい): (1) Gesellschaft, Welt, Öffentlichkeit, Allgemeinheit, Personengruppe, (2) Sozialkunde, Gesellschaftskunde (Abk.)
変 (へん): (1) Veränderung, Vorfall, gefährliches Ereignis, (2) Aufruhr, Aufstand, (3) Unglücksfall, Notfall, (4) Erniedrigung einer Note, (5) Seltsamkeit, Wunderlichkeit, Verschrobenheit, (6) Verdächtigkeit, verdächtiges Aussehen, merkwürdig, seltsam, komisch, ungewöhnlich, verdächtig verrückt
行う (おこなう): durchführen, handeln, sich benehmen, ausüben, ausführen, halten, tun, erfüllen, bewerkstelligen, vollziehen, abhalten, feiern
小説 (しょうせつ): Roman, Erzählung, Novelle, Kurzerzählung, Geschichte
急ぐ (いそぐ): (1) sich beeilen, Arbeit schnell erledigen, es eilig haben, (2) (an einen Ort) eilen, schnell an einen Ort gehen, (3) vorbereiten, Vorbereitungen treffen
真面目 (まじめ): (1) Ernst, Ernsthaftigkeit, (2) Ehrlichkeit, Aufrichtigkeit, (1) ernst, ernsthaft, (2) gewissenhaft, seriös, im Ernst, ernsthaft
親切 (しんせつ): Freundlichkeit, Güte, Wohlwollen, Gefälligkeit, freundlich, gütig, wohlwollend, gefällig, liebenswürdig, freundlicherweise, gütigerweise, wohlwollend
食事 (しょくじ): Essen, Mahlzeit, Mahl, essen, speisen
動く (うごく): (1) sich bewegen, sich rühren, sich regen, (2) gehen, laufen, funktionieren, in Betrieb sein, (3) verändern, wechseln, (4) bewegt sein, gerührt sein, (5) versetzen, transferieren
技術 (ぎじゅつ): (1) Kunst, Handwerk, Gewerbe, (2) Technik, Technologie, technisches Know-how
最初 (さいしょ): (1) Allererster, Erster, (2) Anfang, Beginn, am Anfang, zuerst, anfangs, (1) erster, (2) Anfangs-…, ursprünglich
捕まえる (つかまえる): (1) fangen, fassen, (2) festnehmen, verhaften, ergreifen
致す (いたす): (1) tun, machen, erreichen, (2) herbeiführen, hervorbringen, mit sich bringen, führen, verursachen
見物 (けんぶつ): (1) Besichtigung, Besuch, Zuschauen, Aufsuchen von Sehenswürdigkeiten, (2) Besucher, Zuschauer, (3) etw., das es Wert ist, betrachtet zu werden, etw., das man gesehen haben sollte, besichtigen, besuchen, zuschauen, zusehen, ansehen
員 (いん): (1) Personenzahl, (2) (an Meishi suffigiert)Mitglied (einer Organisation)
挨拶 (あいさつ): (1) Gruß, Begrüßung, Verbeugung, Höflichkeitsfloskel, (2) Antwort, Erwiderung, (3) Bescheid, Nachricht, (4) Besuch, Höflichkeitsbesuch, (5) Ansprache, Begrüßungsrede, (6) Entschuldigung, Erlaubnis, (1) begrüßen, grüßen, seine Verbeugung machen, salutieren, (2) sich entschuldigen, antworten
パソコン: PC, Personalcomputer (Abk.)
進む (すすむ): (1) vorwärts gehen, vorgehen, marschieren, (2) voranschreiten, vorangehen, weitergehen, fortschreiten, Fortschritte machen, (3) zurechtkommen, (4) vorgehen (eine Uhr), (5) Lust haben
治る (なおる): genesen, heilen, wieder gesund werden, (1) repariert werden, repariert sein, (2) korrigiert werden, korrigiert sein, (3) wiederhergestellt werden, wiederhergestellt sein
退院 (たいいん): (1) Entlassung aus dem Krankenhaus, (2) Rückzug eines Hauptpriesters aus seiner Stellung, (3) Entlassung eines Mönches aus seinem Posten und Verstoßung aus dem Tempel (als Bestrafung; in der Edo-Zeit), aus dem Krankenhaus entlassen werden, die Klinik verlassen
壊れる (こわれる): (1) kaputt gehen, entzweibrechen, entzwei gehen, zerstört werden, zerbrechen, (2) gestört sein, außer Betrieb sein, (3) beschädigt sein, gestört sein, (4) zunichte werden (ein Plan od. Versprechen)
文化 (ぶんか): Kultur, Bunka (Ärabez.: 11.2.1804–22.4.1818)
世界 (せかい): (1) Welt, Erde, Erdkugel, Globus, (2) Kosmos, Universum, Weltall, (3) Kreise, Gesellschaft, Welt
遠く (とおく): (1) Ferne, fernes Land, ferne Provinz, (2) ferne Vergangenheit, ferne Zukunft, weit, fern, weit entfernt, entlegen
考える (かんがえる): (1) denken, nachdenken, (2) bedenken, erwägen, sinnen, sich überlegen, grübeln, (3) meinen, glauben, (4) sich erinnern, sich entsinnen, sich vorstellen, sich einbilden, (5) annehmen, vermuten, (6) halten für …, nehmen für …, sehen als …
ご覧になる (ごらんになる): sehen, schauen, betrachten
世話 (せわ): (1) Hilfe, Beistand, Unterstützung, (2) Pflege, Betreuung, Fürsorge, (3) Vermittlung, Besorgung, (4) Sorge, Mühe, (5) Bemühung, (1) helfen, beistehen, unterstützen, (2) pflegen
医学 (いがく): Medizin, Heilkunde, medizinische Wissenschaft
郊外 (こうがい): Vorstadt, Vorort, nähere Umgebung einer Stadt
お出でになる (おいでになる): (1) gehen, (2) kommen, (3) sein, da sein
若し (もし): wenn …, falls …, im Falle, dass …, angenommen, dass …, vorausgesetzt, dass …
危険 (きけん): Gefahr (für Leib und Leben, für einen Schaden), Gefährlichkeit, Unsicherheit, gefährlich
米 (こめ): (1) (geschälter, ungekochter)Reis, (2) Reis, Oryza sativa, (1) Reis, (2) 88 Jahre
乗り換える (のりかえる): (1) umsteigen, (2) wechseln (z.B. die Seiten, das Studienfach od. Aktien)
パパ: Papa
起こす (おこす): (1) aufstellen, aufrichten, aufheben, jmdm. aufhelfen, auf die Beine stellen, (2) wecken, aufwecken, aufrütteln, (3) umgraben, pflügen, (4) aufbrechen, (5) umdrehen (z.B. einen Stein), (6) aufdecken (eine umgedrehte Karte), umdrehen, (7) verursachen, bewirken, veranlassen, hervorrufen, (8) hervorrufen (ein Gefühl), (9) gründen (z.B. ein Land, ein Institut, eine Zeitung), stiften (ein Schule etc.), (10) zum Blühen bringen (eine Aktivität), (11) transkribieren (ein Tonband, ein Stenogramm), (12) schnitzen (eine Druckplatte), (13) aufrühren, aufwühlen, (14) bekommen (eine Krankheit), befallen werden
確り (しっかり): (1) stark, fest, solide, gediegen, haltbar, (2) standhaft, entschlossen, tapfer, wacker, (3) ausdrücklich, entschieden, positiv, (4) hart, zielbewusst, unverdrossen
悲しい (かなしい): traurig, betrübt, unglücklich, bekümmert, kummervoll, schmerzerfüllt
見つかる (みつかる): gefunden werden, entdeckt werden, gesehen werden, ans Licht kommen, ertappt werden, erwischt werden
駄目 (だめ): (1) (2) , (1) nutzlos, zwecklos, nicht gut, (2) vergeblich, zum Scheitern verurteilt, (3) hoffnungslos, unmöglich
高校 (こうこう): Oberschule (Abk.)
糸 (いと): (1) Faden, Garn, Zwirn, Schnur, Leine, Saite, (2) Angelschnur
此れから (これから): von jetzt an, nun, fernerhin, fortab, danach, in Zukunft, künftig
売り場 (うりば): Verkaufsstand, Verkaufsabteilung
光 (ひかり): (1) Licht, Leuchten, Lichtstrahl, (2) etw. Leuchtendes, (3) Licht, fürs menschliche Auge sichtbare elektromagnetische Strahlung, (4) Sehkraft, Sehvermögen, Augenlicht, (5) Glanz der Augen, (6) Lichtblick, Hoffnung, (7) Einfluss, Geltung, (8) Glanz, Schein, Glätte, Politur, (9) Schimmer, Glimmer, (10) Funkeln, Gefunkel, (11) Nimbus, Ruhm, Ehre, (12) Einfluss, Macht (z.B. des Geldes)
仰っしゃる (おっしゃる): sagen (höflicher Ausdruck für iu言う)
然う (そう): (1) ja, (2) nein (als Antwort auf eine verneinte Frage), (3) so, ein solcher, (4) so sehr
厳しい (きびしい): würdig, feierlich, ernst, gesetzt, gewichtig, weihevoll, (1) streng, strikt, unerbittlich, unnachgiebig, rigoros, (2) heftig, hart, ernst, schlimm, rau, herb, brutal, (3) unnahbar, (4) dicht, gedrängt, (5) intensiv, bitter, beißend, (6) wichtig, bedeutend
コンサート: Konzert
捨てる (すてる): (1) wegwerfen, wegschleudern, (2) verlassen, im Stich lassen, aussetzen, jmdn. sitzen lassen, (3) aufgeben, entsagen, verzichten, opfern
易い (やすい): leicht, einfach
そろそろ: (1) langsam, gemächlich, (2) allmählich, bald, nach und nach, schrittweise, zögernd
暫く (しばらく): kurze Zeit, ein Weilchen, einen Moment, einen Augenblick, eine Weile, eine Zeitlang, Moment, Augenblick (im)Nu
吃驚 (びっくり): Erschrecken, Verblüffung, Erstaunen, Überraschung, erschrecken, sich erschrecken, sich entsetzen, verblüfft sein, baff sein, bestürzt sein, erstaunt sein, erstaunen
変わる (かわる): (1) sich ändern, sich verändern, anders werden, sich verwandeln, (2) anders sein, verschieden sein, sich unterscheiden, (3) originell sein
瓦斯 (ガス): (1) Gas, (2) dichter Nebel, (3) Blähungen
相談 (そうだん): Beratung, Besprechung, Unterredung, Rat, Konferenz, Rücksprache, Konsultation, beraten, besprechen, um Rat fragen
寺 (てら):  (buddhist.)Tempel
必要 (ひつよう): etw., was man unbedingt benutzen muss, Notwendigkeit, Unerlässlichkeit, Not, Bedürfnis, Erfordernis, notwendig, erforderlich, nötig, unentbehrlich, unerlässlich
湖 (みずうみ): See
学部 (がくぶ): Fakultät, Fachbereich, Department, Abteilung (an einer Universität)
砂 (すな): Sand, (1) Sand,  (körniger)Staub, (2) Silber‑ und Goldstaub (für Lackarbeiten oder in Papier)
写す (うつす): (1) kopieren, abschreiben, abzeichnen, (2) fotografieren, einen Film drehen
迎える (むかえる): (1) abholen, entgegengehen, entgegenkommen, begrüßen, willkommen heißen, (2) hereinholen, einladen, empfangen, (3) in eine Situation eintreten, erreichen (eine Zeit), begrüßen (z.B. einen besonderen Tag), (4) willfährig sein, entgegenkommen, nach kommen, nach jmds. Pfeife tanzen, (5) schmeicheln, (6) heiraten, zur Frau nehmen, sich vermählen, (7) holen, kommen lassen, (8) abfangen (den Feind), entgegentreten, begegnen (einem Angriff, einem Problem)
勝つ (かつ): gewinnen, siegen
再来月 (さらいげつ): übernächster Monat
連絡 (れんらく): Verbindung, Verknüpfung, Briefwechsel, Anschluss, Knotenpunkt, Kontakt, Liaison, jmdn. mit etw. in Verbindung bringen, sich in Verbindung setzen, mitteilen, verständigen, durchgeben, weiterleiten
浅い (あさい): (1) seicht, nicht tief (z.B. See, Fluss), flach, (2) oberflächlich (z.B. Wunde), nicht tief, (3) schwach, unbedeutend (z.B. eine Leistung), (4) hell (Farbe), (5) flüchtig (z.B. Gefühle), leicht, leise
音 (おと): Ton, Schall, Laut, Klang, Geräusch, Ton, Laut, (1) Ton, Laut, Geräusch, (2) Nachricht, Mitteilung, Gerücht, (3) Antwort, Erwiderung, (4) Phon
けど: aber, jedoch, obwohl, allerdings (), aber, jedoch, obwohl, allerdings
代わり (かわり): (1) Vertreter, Stellvertreter, (2) Ersatz, (3) Nachschlag, ersatzweise, alternativ, neu
別れる (わかれる): (1) Abschied nehmen, sich trennen, (2) sich scheiden lassen, in Scheidung leben
間に合う (まにあう): (1) rechtzeitig kommen, pünktlich sein, nicht zu spät sein, (2) ausreichen, genügen, genug sein, mit … auskommen, mit … hinkommen
落ちる (おちる): (1) fallen, hinabfallen, herabfallen, abstürzen, (2) zusammenfallen, einfallen, (3) tropfen, tröpfeln, (4) fehlen, wegfallen, wegbleiben, (5) untergehen, sinken, sich neigen, (6) abfallen, (7) abgehen, ausgehen, (8) übergangen werden, ausgelassen werden, (9) durchfallen, (10) nachlassen, (11) zufallen, in die Hände fallen, (12) eingenommen werden
間 (あいだ): (1) Raum, Zwischenraum, Abstand, Entfernung, (2) Beziehung, (3) Zeitraum, Intervall, (1) Abstand zwischen zwei Dingen, (2) Beziehung zwischen zwei Dingen
輸出 (ゆしゅつ): Ausfuhr, Export, exportieren, ausführen
杯 (はい): (1) Glas, Tasse, Becher, (2) … Gläser, … Tassen, … Löffel (Zählwort für mit etw. gefüllte Tassen, Gläser und Löffel)
オートバイ: Motorrad (ausgenommen Motorroller)
柔道 (じゅうどう): Jūdō
電報 (でんぽう): Telegramm
血 (ち): (1) Blut, (2) Lebenskraft, Leidenschaft, menschliches Gefühl, Menschlichkeit, (3) Blutsverwandtschaft, Blut
盗む (ぬすむ): (1) stehlen, einen Diebstahl verüben, rauben, klauen, (2) sich der Aufmerksamkeit anderer entziehen, sich wegstehlen, (3) eine kurze Weile für etwas nutzen, (4) abschreiben, plagiieren, ein Plagiat begehen, plündern
ワープロ: (1) Textverarbeitungsprogramm, (2) japanische Schreibmaschine
下着 (したぎ): Unterwäsche
試合 (しあい): Wettkampf, Spiel, Match, Turnier
見える (みえる): (1) sichtbar sein, (2) sehen können, (3) aussehen, scheinen, erscheinen, (4) kommen (ehrerb.-höfl.), (5) gesehen werden, (6) zeigen, (7) (eine vornehme Person) treffen, (8) Ehefrau werden, heiraten
召し上がる (めしあがる): etw. zu sich nehmen, essen
空港 (くうこう): Flughafen, Flugplatz, Airport
光る (ひかる): (1) scheinen, leuchten, funkeln, schimmern, (2) glänzen, (3) brillant sein, nicht gleich kommen, (4) kontrollieren, unter Kontrolle halten, (5) im Schein von etw. stehen, schön beleuchtet werden, (6) eine blendene Erscheinung haben, (7) Einfluss haben
政治 (せいじ): Politik, Staatskunst, Regierung, Verwaltung, politische Angelegenheiten
客 (きゃく): (1) (2) 
笑う (わらう): (1) lachen, lächeln, (2) auslachen, verlachen, hohnlachen (auch 嗤う geschrieben)
お礼 (おれい): (1) Gruß, Begrüßung, Verbeugung, (2) gute Manieren, (3) Dankbarkeit, Vergütung (höfliche Form von rei礼)
落とす (おとす): (1) fallen lassen, hinschmeißen, (2) verlieren, (3) auslassen, übersehen, (4) erobern, einnehmen, (5) beseitigen, entfernen, abziehen, wegtun, (6) abwaschen, (7) herabsetzen, reduzieren, (8) erniedrigen, degradieren, entehren, (9) (Lautstärke) verringern,  (die Stimme) senken, (10) ausgeben
開く (ひらく): (1) sich öffnen, (2) sich öffnen lassen, (3) sich weiten, (4) auf gehen (eine Blüte), blühen, (5) ausbreiten, (6) zerstreuen, (7) aufmachen, öffnen, (8) eröffnen, abhalten, (9) sich öffnen, aufgehen, aufbrechen, (10) die Blüte öffnen, blühen, (11) einen Laden eröffnen, ein Gewerbe aufmachen, (12) eine Veranstaltung eröffnen, (13) erschließen, (14) ziehen (die Wurzel), (15) veröffentlichen (Holzdrucke)
予習 (よしゅう): Vorbereitung (auf den Unterricht), vorbereiten
噛む (かむ): (1) beißen, (2) kauen, nagen, (3) stammeln, sich versprechen
島 (しま): Shima, Insel, Eiland, Inselchen, Atoll
冷える (ひえる): kalt werden, erkalten, abkühlen (auch übertr.)
腕 (うで): (1) Arm, (2) Leistung, Fähigkeit, Talent, Geschicklichkeit
文学 (ぶんがく): Literatur, Dichtung, Schrifttum
うん: (1) ja, hum!, hmm! (als Zustimmung), (2) mmh! (Stöhnen)
教会 (きょうかい): (1) Kirche, Gemeinschaft der Gläubigen, (2) Kirche, Gotteshaus, Kapelle, Kathedrale, Dom, kirchlich, Kirchen…
都合 (つごう): (1) (2) , einrichten, arrangieren, möglich machen, besorgen, beschaffen, aufbringen
お子さん (おこさん): (1) das Kind jmds. anderen, (2) Ihr Kind (ehrerb.-höfl.)
カーテン: Vorhang, Gardine
自由 (じゆう): Freiheit, Freisein, frei, unabhängig, uneingeschränkt, unbeschränkt, liberal, ungebunden, ungehemmt, ungehindert, ungezwungen, zwanglos, selbständig
展覧会 (てんらんかい): Ausstellung
スーパー: (1) Super…, super, (2) Supermarkt, (3) Überblendung, Überlagerung, Untertitel, Super Mario (Videospielreihe von Nintendo)
偶に (たまに): gelegentlich, selten, hin und wieder, manchmal, bisweilen
無くなる (なくなる): (1) aufgebraucht sein, alle werden, verschwinden, zu Ende gehen, (2) verloren gehen, abhanden kommen, dahin sein, nicht da sein, Einbußen erleiden, (3) aussterben, verschwinden
ハンドバッグ: Handtasche
やっと: (1) endlich, schließlich, (2) gerade noch, mit Mühe und Not, mit knapper Not
向かう (むかう): (1) nach … gerichtet sein, sich zuwenden, sich richten nach, (2) gehen, fahren, fliegen, den Weg einschlagen nach …, (3) neigen, tendieren, eine Tendenz haben, (4) sich widersetzen, widerstehen, Widerstand leisten, entgegentreten, sich entgegenstellen, losgehen auf
以外 (いがい): (1) außer …, ausgenommen …, abgesehen von …, außer …, mit Ausnahme von …, ohne …, nur …, (2) außerdem, auch noch, darüber hinaus, ferner, noch dazu, überdies, (3) Gebiet außerhalb von etw
レジ: Kasse, Registrierkasse, Ladenkasse (Abk.)
警察 (けいさつ): (1) Polizei (die Organisation), (2) polizeiliche Tätigkeiten, (3) Polizeiwache, (4) Polizeibeamter, Polizist
移る (うつる): (1) den Ort wechseln, umziehen, umsteigen, (2) sich verändern, sich ändern, wechseln, sich wandeln, (3) sich einer anderen Sache zuwenden, (4) übertragen (Geruch, Farbe), (5) jmdn. anstecken (mit einer Krankheit), (6) übergreifen (Feuer), sich ausbreiten, Feuer fangen, (7) aufsteigen, voranschreiten, (8) vergehen (Zeit), (9) verblassen, die Farbe verlieren
人形 (にんぎょう): (1) etw. in Menschenform,  (insbes.)Papierpuppe, die bei Reinigungszeremonien verwendet wird, (2) Puppe, Marionette, (3) willenlose Person, Person ohne eigene Ansicht
仕舞う (しまう): (1) beenden, (2) schließen, (3) einräumen, aufräumen, wegräumen, verstauen, (4) etw. zu Ende tun, (5) etw. Unangenehmes erleben
二階建て (にかいだて): zweigeschossiges Gebäude, Zweigeschosser
喜ぶ (よろこぶ): (1) sich freuen, sich erfreuen, Freude empfinden, sich vergnügen, sich weiden, (2) etw. für erfreulich halten, (3) mit einem freudigen Ereignis gesegnet sein, (4) etwas Angenehmes empfangen, (5) gebären, von einem Kind entbunden werden
ジャム: Marmelade, Konfitüre, Francis Jammes (franz. Schriftsteller; 1868–1938)
仕方 (しかた): Art, Weise, Methode, Mittel, Weg
決して (けっして): auf keinen Fall, nie, niemals, keineswegs, keinesfalls, nicht im mindesten (mit Verneinung)
久しぶり (ひさしぶり): (1) lange Zeit, lange Zwischenzeit, (2) seit langer Zeit, nach langer Zeit
それ程 (それほど): derart, so sehr, in dem Grade, dass …, so dass
大事 (だいじ): (1) wichtige Sache, wichtige Angelegenheit, (2) ernste Angelegenheit, (3) wichtig, ernst, lieb und teuer, (1) wichtige Angelegenheit, ernste Angelegenheit, (2) schlimme Angelegenheit, Unglück, (3) Ausbildung zum Priester und Erlangung der Erleuchtung, (4) Wichtigkeit, (1) wichtig, wertvoll, (2) ernst, (3) lieb und teuer, sorgfältig
細かい (こまかい): (1) klein, winzig, (2) fein, ausführlich, genau, detailliert
貰う (もらう): (1) bekommen, erhalten, kriegen, empfangen, adaptieren, erwerben, (2) adoptieren, (3) heiraten, (4) jmdn. etw. für sich tun lassen
ご存じ (ごぞんじ): Wissen, Kenntnis, Einsicht (ehrerb.-höfl.)
法律 (ほうりつ): Gesetz, Recht
クラブ: (1) Krabbe, (2) Laufkatze, Winkelkatze, (1) Kreuz, Treff, (2) Golfschläger
趣味 (しゅみ): Interesse, Geschmack, Hobby
其れで (それで): (1) also, daher, deshalb, demzufolge, so dass, (2) und, und dann
僕 (ぼく): (1) ich (vertraulich im Ton; Männersprache; kam in dieser Bedeutung während der Meiji-Zeit unter Studenten auf und ging dann in die Umgangssprache über), (2) Kleiner, du (Anrede für kleine Jungen), (3) (urspr.)Diener, Knecht, mein
夫 (おっと): Ehemann, Mann
市 (し): Stadt (als öffentliche Verwaltungseinheit)
家内 (かない): (1) (jmds. eigene)Frau (jmds. eigene)Ehefrau, (2) Familie, (3) Inneres des Hauses, (4) im Haus, (1) inneres des Hauses, (2) Familienmitglied
驚く (おどろく): (1) erstaunt sein, sich wundern, überrascht sein, erschrecken, einen Schrecken bekommen, bestürzt sein, verwirrt sein, verblüfft sein, (2) beeindruckt sein, bewundern, (3) mit einem Schrecken bemerken, (4) aufwachen
講義 (こうぎ): Vortrag, Vorlesung, einen Vortrag halten, eine Vorlesung geben
お釣り (おつり): Wechselgeld,  (ugs.)Rückgeld,  (schweiz.)Retourgeld, Herausgeld
安心 (あんしん): (1) Ruhe, Beruhigung, Seelenruhe, Erleichterung, (2) Sorgenfreiheit, (3) Friedlichkeit, beruhigt sein, sich beruhigen, erleichtert sein, sicher
この頃 (このごろ): (1) jetzt, heutzutage, neuerdings, gegenwärtig, in diesen Tagen, (2) in letzter Zeit, in der letzten Zeit, (3) die letzten Tage
踏む (ふむ): (1) treten, stampfen, auftreten, betreten, (2) ausführen, erfüllen, ausüben, beenden, (3) schätzen, veranschlagen, (4) reimen
始める (はじめる): anfangen, beginnen, eröffnen, errichten, gründen
だから: (1) deshalb, daher, also, darum, demnach, somit, (2) da, denn, weil
間違える (まちがえる): (1) sich irren, einen Fehler machen, einen Schnitzer begehen, sich versehen, falsch machen, (2) verwechseln, sich täuschen, verkennen, (3) missverstehen
出来るだけ (できるだけ): soweit es geht, soweit wie möglich
運ぶ (はこぶ): (1) bringen, tragen, befördern, transportieren, schaffen, fahren, (2) gehen, sich begeben, (3) fortschreiten, Fortschritte machen, ausführen, (4) mittels einer Sache arbeiten, (5) fördern, vorantreiben, protigieren
泊まる (とまる): (1) übernachten, (2) ankern, vor Anker liegen, (3) Nachtdienst haben
高等学校 (こうとうがっこう): Oberschule, Gymnasium
冷房 (れいぼう): Klimatisierung, Klimaanlage, klimatisieren
会話 (かいわ): Unterhaltung, Gespräch, Konversation, sprechen, sich unterhalten, ein Gespräch führen
店員 (てんいん): Verkäufer, Angestellter
運動 (うんどう): (1) Bewegung, (2) Aktivität, Bewegung, Bewegtheit, (3) Sport, Training, Übung, (4) Kampagne,  (pol., soz. etc.)Bewegung, (5) aktive Bewegung, sich bewegen, sich bemühen, werben, sich bewerben
怖い (こわい): (1) fürchterlich, entsetzlich, schrecklich, schlimm, furchtbar, grässlich, schauderhaft, schauerlich, schrecklich, (2) angst, bang, angst und bange, (3) unheimlich, nicht geheuer
復習 (ふくしゅう): Wiederholung (von etw. Gelerntem), wiederholen (Gelerntes)
合う (あう): (1) passen, angemessen sein, (2) übereinstimmen, übereinkommen, im Einklang stehen, entsprechen, gut stehen, (3) zusammenpassen, (4) korrekt sein
漬ける (つける): (1) eintauchen, einweichen, (2) einlegen, einmachen, einpökeln
硝子 (ガラス): Glas (als Material), Glasartigkeit
通る (とおる): (1) entlanggehen, entlangfahren, (2) vorbeigehen, vorbeifahren, (3) hindurchgehen, hindurch fahren, passieren, (4) eintreten, (5) eine Prüfung bestehen, (6) gelten als …, anerkannt sein als …, (7) zulässig sein, erlaubt sein, (8) konsequent sein, logisch sein
居る (おる): sein
アナウンサー: (1) Sprecher, Nachrichtensprecher, (2) Ansager
伝える (つたえる): (1) übermitteln, mitteilen, ausrichten, sagen, senden, (2) überliefern, (3) lehren, einweihen, (4) einführen, (5) leiten, fortpflanzen
注意 (ちゅうい): (1) Aufmerksamkeit, (2) Vorsicht, Achtung, (3) Warnung, aufpassen, Acht geben
済む (すむ): (1) enden, zu Ende gehen, beendet werden, zu Ende sein, beendet sein, fertig sein, (2) nicht benötigen, ohne zurecht kommen, (3) bezahlt werden
レポート: Bericht, Forschungsbericht, Protokoll, Referat, Klausur
乗り物 (のりもの): Fahrzeug
止める (やめる): sein Amt niederlegen, aufgeben, aufhören, abdanken, sich zurückziehen, zurücktreten, einstellen, abbrechen, unterbrechen, verzichten, zurücktreten, aufhören, aufgeben
探す (さがす): suchen, fahnden, ausfindig machen, suchen, nachschauen, nachschlagen, fahnden, forschen nach
連れる (つれる): mitnehmen, mitbringen, begleiten (eine Person, ein Tier)
打つ (うつ): schlagen, hauen, klopfen, einschlagen, ohrfeigen, hineintreiben
遊び (あそび): (1) Spiel, Spielen, Sport, Kurzweil, Spaß, Vergnügen, Zeitvertreib, (2) Ausschweifung, Liederlichkeit, Schwelgerei, Völlerei, (3) Lustreise, (4) sinnliche Vergnügungen, (5) Spiel, Bewegungsfreiheit, Spielraum (zweier Maschinenteile)
事 (こと): (1) Ding, Sache, Affäre, Angelegenheit, Vorfall, Vorkommnis, (2) Umstand, (3) Ereignis, Begebenheit, Vorfall, Vorkommnis, (4) Geschäft, Beschäftigung, Betätigung, Tätigkeit, Verrichtung, (5) Erfahrung
柔らかい (やわらかい): (1) weich, sanft, zart, elastisch, (2) mild, sanft, (3) locker, nicht förmlich
続く (つづく): (1) dauern, andauern, fortdauern, währen, anhalten, (2) folgen, weiterführen, (3) sich erstrecken
無理 (むり): (1) Unvernunft, Unfug, Unvernünftigkeit, Unbill, Unrecht, Zwang, (2) Gewalt, Zwang, (3) schwierige Durchführbarkeit, Unmöglichkeit, (4) Irrationalität, (1) etwas mit Gewalt tun, etw. Schwieriges versuchen, (2) sich überanstrengen, sich übernehmen, unmöglich, unvernünftig, unbillig, unrecht, zwangsmäßig, mit Gewalt, gewaltsam, zwangsweise
ガソリン: Benzin, Sprit
様 (よう): (1) Art und Weise, (2) wie
普通 (ふつう): (1) Normalität, Gewöhnlichkeit, Gebräuchlichkeit, (2) Allgemeinheit, (3) Durchschnittlichkeit, normalerweise, allgemein, gewöhnlich, normal, im Allgemeinen, normal, gewöhnlich, gebräuchlich, einfach, durchschnittlich, verbreitet, allgemein, mittelmäßig, üblich, generell
送る (おくる): (1) senden, schicken, transportieren, transportieren lassen, (2) verabschieden, jmdn. an einen Ort bringen oder begleiten, (3) überweisen, (4) verbringen, führen (ein Leben)
壊す (こわす): (1) kaputt machen, zerbrechen, entzweibrechen, zerstören, niederreißen, abreißen, vernichten, beschädigen, demolieren, ruinieren, (2) verletzen, (3) verderben, (4) die Funktion stören, behindern, (5) wechseln (Geld in kleinere Scheine od. Münzen), Geld klein machen
又は (または): (1) oder, (2) entweder … oder …, mit anderen Worten
触る (さわる): berühren, anfühlen, betasten, antasten, fühlen
引っ越す (ひっこす): umziehen, den Wohnort wechseln
集める (あつめる): (1) sammeln, versammeln, zusammenbringen, eine Sammlung machen, zusammenrufen, (2) vereinigen, konzentrieren, (3) eintreiben, einziehen, erheben, einsammeln
