大人 (おとな): Erwachsener, Erwachsener, erwachsener Mensch, erwachsen
クラス: (1) Klasse, (2) Unterrichtsstunde, (3) Klasse, Objektklasse
女の子 (おんなのこ): Mädchen, Mädel, weibliches Baby
静か (しずか): still, ruhig, leise, sanft, gelassen, sacht, lautlos, schweigsam, friedlich, langsam, still, ruhig, leise, sanft, gelassen, sacht, lautlos, leise, schweigsam, friedlich, langsam
着く (つく): (1) ankommen, erreichen, eintreffen, gelangen, (2) langen bis …, reichen bis an …, (3) Platz nehmen
方 (ほう): (1) Richtung, Seite, (2) Gegend, Gebiet
ニュース: Nachrichten, Neuigkeiten, Nachrichten (meist in Zusammensetzungen verwendet)
電話 (でんわ): (1) Telefon, Telefonapparat, (2) Anruf, Telefonat, Telefongespräch, Telefonieren, anrufen, telefonieren
飲み物 (のみもの): Getränk, etw. zu trinken, Trank, Trunk
茶色 (ちゃいろ): (1) Braun, (2) helles Braun, braun
鶏肉 (けいにく): Huhn, Hühnerfleisch, Geflügel
重い (おもい): (1) schwer, schwerwiegend, (2) ernst, ernsthaft, bedeutend, bedeutsam, wichtig, seriös, (3) niedergeschlagen, niedergedrückt, bedrückt, deprimiert, entmutigt
父 (ちち): Vater, (1) Vater (insbes. der eigene Vater), leiblicher Vater, (2) Stiefvater, Adoptivvater, (3) geistiger Vater, Erfinder, Entdecker, (4) himmlischer Vater, Gott
元気 (げんき): (1) Energie, Vitalität, Lebenskraft, Mut, Schwung, (2) Gesundheit, (3) Lebenskraft als Basis des Werdens aller Dinge, (1) gesund, munter, (2) lebhaft, frisch, lebendig
建物 (たてもの): Gebäude, Bau, Bauwerk
切手 (きって): (1) Briefmarke (eigentl. Abk.), (2) Zahlungsbeleg, Quittung
易しい (やさしい): (1) leicht, einfach, mühelos, (2) leicht verständlich, schnörkellos
磨く (みがく): (1) polieren, glätten, putzen, schleifen, bürsten, (2) verbessern, entwickeln, üben, trainieren
タクシー: Taxi
好き (すき): Zuneigung, Neigung, Geschmack, Vorliebe, Lieblings…, Leib…
走る (はしる): (1) laufen, rennen, fahren, segeln, traben, (2) verlaufen, (3) überlaufen, (4) laufen (z.B. auf Windows)
お母さん (おかあさん): (1) Mutter (höfliche Bez. der Mutter jmds. anderen), (2) Mama, Mutti (höfliche Anrede der eigenen Mutter)
短い (みじかい): (1) kurz, knapp, (2) ungeduldig
良い (よい): (1) gut, schön, (2) hervorragend, ausgezeichnet, (3) wohl, (4) günstig, richtig, passend, (5) besser
風呂 (ふろ): Bad
今日は (こんにちは): Guten Tag! (Verschleifung von Konnichi wa!; insbes. in Edo bzw. Tōkyō–Shitamachi gebräuchlich)
大きな (おおきな): (1) groß, gewaltig, mächtig, (2) riesig, gigantisch, immens, ungeheuer, (3) laut, (4) dick
家 (いえ): (1) Haus, Gebäude, Wohnung, Zuhause, Heim, (2) Ort, an dem eine Familie lebt, (3) Haushalt, Familie, (4) Hausfrau, Ehefrau, (5) Familienerbe, (6) Familiensituation, (7) finanzielle Situation einer Familie, (8) Berühmtheit einer Familie, Ruf der Familie, (9) Laienleben in der Familie, (10) Schachtel für Geräte, (11) Schachtel für Teegerät
背 (せい): Größe, Körpergröße, Statur, Wuchs
紙 (かみ): Papier
並べる (ならべる): (1) aufreihen, nebeneinander stellen, aufstellen, nebeneinander legen, (2) gegenüberstellen, vergleichen, (3) Beweise aufführen, (4) aufzählen, auflisten, eine Aufstellung machen, (5) spielen (ein Brettspiel)
何 (なに): (1) welcher, welche, welches, (2) etwas, (3) was?, wie?, wie bitte?, (1) was, welcher, (2) wie viel
音楽 (おんがく): (1) Musik, Tonkunst, (2) Ongaku (Musikart im Kabuki)
お父さん (おとうさん): Vater (höfliche Anrede des eigenen Vaters od. Bez. des Vater jmd. anderes)
自動車 (じどうしゃ): Auto, Automobil, Kraftfahrzeug, Wagen
黒い (くろい): (1) schwarz, schwärzlich, dunkel, (2) düster, schlecht, (3) schmutzig, verschmutzt, (4) böse, schlecht
一日 (いちにち): (1) ein Tag, (2) erster Tag eines Monats, Monatserster, (3) jener Tag, (4) eines Tages (bei adverbialer Verwendung: 0-Akzent), (1) ein Tag, (2) eines Tages, (3) ein voller Tag, (4) den ganzen Tag, von morgens bis abends, (5) der erste Tag (eines Monats), (1) ein Tag, (2) den ganzen Tag, (3) neulich, vor Kurzem, dieser Tage, (4) erster
側 (がわ): (1) Seite von etw, (2) Tuch, in das vieles eingewickelt ist, Seite, Reihe
今週 (こんしゅう): diese Woche
ポスト: (1) Posten, Stellung, Anstellung, (2) Position (z.B. Fußball), (3) Posten, Briefkasten, posten
か: Fragepartikel, satzabschließende Fragepartikel, oder
犬 (いぬ): (1) Hund, Hündin, Rüde, Welpe, Wauwau, Canis familiaris, (2) Spion, (3) Angeber, (4) (als Präfix) unwürdig, nichtsnutzig, wertlos, (5) (als Präfix) falsch, gefälscht, nachgemacht, (6) (als Präfix) vergeblich, verschwenderisch, nutzlos, fruchtlos
女 (おんな): Frau (urspr. junge Frau), (1) Frau, Dame, Fräulein, Frauenzimmer, Weib, Weibsbild, schönes Geschlecht, (2) Geliebte, Mädchen, Freundin
次 (つぎ): (1) der Nächste, der Folgende, der Kommende, (2) Station, Poststation, nächster, folgender, kommender
村 (むら): Dorf, Weiler, Nest
一月 (ひとつき): (1) ein Monat, (2) erster Monat, Januar, (1) ein Monat, (2) den ganzen Monat
円 (えん): (1) Kreis, Kugel, (2) Kreis, (3) Yen, ¥
色 (いろ): (1) Farbe, Färbung, Farbton, Tinte, (2) Teint, Gesichtsfarbe, Hautfarbe, (3) Aussehen, Ausdruck, (4) Liebe, erotische Leidenschaft, Wollust, (5) Liebschaft
花 (はな): (1) Blume, Blüte, (2) (bes.)Pflaumenblüte, (3) (ganz bes.)Kirschblüte, (4) Buddha geopferte Zweige und Blätter, (5) Zierde, Schmuck, Schönheit, Schöne, (6) Blüte, Blütezeit, Aufschwung, (7) Blumenfarbe, (8) Ikebana, Blumenstecken, (9) Spiel mit japanischen Spielkarten, (10) Spielkarten
耳 (みみ): (1) Ohr, Auris, (2) Hören, (3) Ohrmuschel, (4) Löffel (bei Hasen und KaninchenJägerspr.), Lauscher (z.B. Rotwild), Luser (z.B. Rotwild), Teller (Schwarzwild), Behang (bei Jagdhunden), (5) Rand, Kante, (6) Salband, Webkante, (7) Griff, Henkel, (8) Eselsohr, (9) Lasche (eines Briefumschlages), (10) Brotrinde
時計 (とけい): Uhr
ご飯 (ごはん): (1) gekochter Reis, (2) Essen, Mahl, Mahlzeit (ehrerb.-höfl.)
洗う (あらう): (1) waschen, abspülen, spülen, (2) sich waschen, (3) schrubben, (4) untersuchen, Untersuchungen anstellen
空 (そら): (1) Himmel, Himmelsgewölbe, (2) Luft, Raum, (3) Wetter, Wetterlage, (4) Platz, Raum, Gegend, (5) Gemütszustand, Seelenzustand, Gefühl, (6) (in der Form sora de) auswendig, aus dem Stegreif, (7) Lüge, (8) oberer Teil, Spitze, (9) (mit nari)Geistesabwesenheit, Zerstreutheit, (10) Unklarheit, (11) (als Präfix) unecht, vorgetäuscht, (12) eingebildet, (13) falsch, (14) grundlos
危ない (あぶない): (1) gefährlich, gefahrvoll, riskant, abenteuerlich, gewagt, (2) bedrohlich, kritisch, ernst, (3) unsicher, instabil, wacklig, (4) unglaubwürdig, unzuverlässig, bedenklich, zweifelhaft
新聞 (しんぶん): Zeitung
六 (ろく): sechs, 6
スリッパ: Pantoffel, Slipper
見せる (みせる): (1) zeigen, sehen lassen, ausstellen, der Öffentlichkeit zugänglich machen, (2) sich zeigen, erscheinen, (3) klar machen, klar zeigen, (4) aussehen, scheinen, (5) konsultieren (einen Arzt),  (einem Arzt) vorstellen, (6) verheiraten, heiraten lassen (eine Frau einen Mann), (7) (als Hilfsverb nach te-Form) etw. tun, damit der andere es lernt oder versteht, vormachen, vor…, (8) etw. absichtlich tun
少ない (すくない): (1) wenig, gering, (2) begrenzt, (3) selten, (4) nicht genug
又 (また): (1) und, außerdem, ferner, noch dazu, obendrein, überdies, weiter, und auch, zudem, (2) wieder, wieder einmal, noch einmal, (3) ein anderes Mal, das nächste Mal, noch einmal, (4) auch, ebenfalls, sowohl als auch, (5) oder, anderer
始め (はじめ): Anfang, Beginn
差す (さす): (1) tragen (ein Schwert), (2) gießen, eingießen, einschenken, (3) scheinen, in eine Farbe getaucht sein, (4) steigen (Flut), (5) hochhalten, die Hände erheben, hineinstecken
フォーク: (1) Gabel, (2) Grabegabel, Mistgabel, Folklore, Folk, Gabel
読む (よむ): (1) lesen, (2) genau durchlesen, untersuchen, (3) rezitieren, (4) entziffern, (5) voraussehen, (6) schätzen, zählen
日 (にち): (1) Japan, (2) japanisch, (3) Sonntag
青 (あお): (1) (2) , Grün, Blau
地下鉄 (ちかてつ): U-Bahn, Untergrundbahn
話す (はなす): (1) sagen, sprechen, reden, (2) erzählen, äußern, (3) sich unterhalten, plaudern, (4) beschreiben, schildern, berichten
先月 (せんげつ): voriger Monat, letzter Monat, Vormonat
掛ける (かける): (1) hängen, herabhängen, aufhängen, aushängen, (2) anhaken, zuhaken, zuschließen, zusperren, (3) lehnen, anlegen, sich hinsetzen, (4) bedecken, decken, zudecken, legen, auflegen, (5) ausgeben, verwenden, anlegen, sich kosten lassen, (6) multiplizieren, (7) stellen, (8) gießen, begießen, bespritzen, (9) besteuern, auferlegen, (10) tragen, aufhaben, umhaben, (11) anreden, ansprechen, (12) telefonieren, anrufen, (13) anstellen, anschalten, (14) aufgeben (Rätsel), (15) geben
生徒 (せいと): Schüler, Schuljunge, Schulmädchen, Pennäler (insbes. für Mittel‑ und Oberschüler verwendet)
迚も (とても): (1) sehr, recht, höchst, überaus, beträchtlich, schrecklich, (2) überhaupt nicht, gar nicht, durchaus nicht, unmöglich, auf keinen Fall (mit Verneinung)
アパート: (1) Mietwohnung, Mietshaus, Mehrfamilienhaus, (2) Wohnung, Apartment (Abk.)
お祖父さん (おじいさん): alter Mann, (1) (mein)Großvater, Opa, (2) ein alter Mann, ein Opa
夜 (よる): Nacht, Nacht, Abend, am Abend, in der Nacht
開く (あく): offen sein, frei werden, leer werden, (1) sich öffnen, aufgehen, sich aufschließen, auffliegen, (2) öffnen (ein Geschäft), beginnen (ein Gewerbe), (3) aufgebraucht werden, (4) leer sein, leer werden, frei werden (ein Zimmer, Gebäude od. Gelände), (5) entstehen (ein Loch), (6) vakant werden, frei werden (eine Stelle), (7) nicht im Gebrauch sein, (8) fertig sein und frei haben, (9) für etw. frei sein, (10) öffnen
難しい (むずかしい): (1) schwierig, schwer, (2) heikel, (3) fraglich, (4) lästig
山 (やま): (1) Berg, Gebirge, Hügel, Anhöhe, (2) Bergwerk, Mine, Zeche, (3) Wald, (4) Haufen, (5) Spekulation, (6) Höhepunkt, wichtiger Punkt, Krise, (7) Endphase, (8) Reifenprofil
洗濯 (せんたく): Wäsche, Waschen, waschen, Wäsche waschen
九日 (ここのか): (1) neunter (Tag eines Monats), (2) neun Tage lang (bei adverbialer Verwendung ist der Akzent 0)
幾つ (いくつ): (1) wie alt, (2) wie viel, wie viele, (3) einige, viele, ein Reihe
十 (じゅう): zehn, (1) zehn, (2) zehn Jahre alt, zehn, zehn (in Dokumenten)
人 (じん): Mensch, Person, Leute (insbes. bei der Einteilung Himmel, Erde und Mensch)
教える (おしえる): (1) lehren, jmdn. unterrichten, jmdm. Unterricht geben, beibringen, unterweisen, (2) informieren, sagen, erklären, erzählen, verkünden, predigen, (3) belehren, mahnen, ermahnen, warnen, (4) verführen, verleiten, überreden, aufwiegeln
太い (ふとい): (1) dick, groß, breit, fett, stark, (2) tief (Stimme), (3) dreist, frech unerschrocken
三 (さん): drei
渡す (わたす): (1) übergeben, einhändigen, abgeben, überreichen, (2) überlassen, übertragen, übergeben, (3) übersetzen, hinüberbringen, (4) auszahlen, (5) (eine Brücke) schlagen
八百屋 (やおや): (1) Gemüsehändler, (2) Gemüsehandlung
返す (かえす): (1) zurückgeben, zurückstellen, zurückzahlen, zurückerstatten, (2) erwidern, (3) zurückschicken, (4) umkehren, umdrehen, umwenden
暗い (くらい): (1) dunkel, düster, lichtlos, düster, trübe, dämmerig, stockfinster, schwach, matt, (2) dunkel, (3) verdächtig, zweifelhaft, zweideutig, (4) trist, düster, trostlos, (5) unwissend, einer Sache unkundig, unbewandert, ohne Erfahrung
聞く (きく): (1) hören, zuhören, (2) gehorchen, befolgen, (3) fragen, befragen, ausfragen
でも: aber
本当 (ほんとう): Wahrheit, Echtheit, Richtigkeit (), (1) Wahrheit, Echtheit, (2) Richtigkeit, wahr, richtig, treu, wirklich, tatsächlich, eigentlich, gehörig, natürlich
向こう (むこう): (1) entgegengesetzte Seite, die entgegengesetzte Richtung, (2) entfernte Seite, (3) die gegenüberliegende Seite (von etw., das durch etw. wie Fluss, Berg o.a. getrennt ist), andere Seite, (4) entferntes Gebiet, Ausland, (5) die andere Partei, er, sie, (6) das Nächste, das Kommende, die nächste Zeit, (7) das Ziel, (8) Eingang zur Rampe der Bühne, Eingang zum Blumensteg, (9) Loge im ersten Stock gegenüber der Bühne
泳ぐ (およぐ): (1) schwimmen, baden, (2) sich durch eine Menschenmenge bewegen, (3) wanken, die Balance verlieren, (4) sich durchmogeln, sich durchschlängeln, (5) sich den Ausschweifungen des Freudenviertels hingeben, (6) Diebesgut verkaufen, (7) einen Platz für einen Diebstahl ausbaldowern
休む (やすむ): (1) ausruhen, ruhen, ruhen lassen, (2) einstellen, stoppen, (3) nicht anwesend sein, fehlen, (4) frei haben, sich frei nehmen, nicht arbeiten, (5) nicht zur Arbeit gehen, nicht zur Schule gehen, (6) pausieren (mit etw., das man eigentlich regelmäßig macht), (7) schlafen, zu Bett gehen, (8) genesen
ええ: (1) ja, (2) äh, wie, wie bitte, (3) nun, also
東 (ひがし): Osten, (1) Osten, (2) Ost…, östlich
テープ: (1) Band, Tonband, (2) Luftschlange, Papierschlange, Papierband, (3) Klebeband
下さい (ください): (1) bitte, geben Sie mir …!, ich hätte gerne …, (2) bitte, seien sie bitte so freundlich und …, darf ich Sie um … bitten. (Meirei・kei von kudasaru下さる)
御免なさい (ごめんなさい): (1) Entschuldigung!, (2) Tut mir leid!, (3) Verzeihen Sie!
傘 (かさ): Schirm
可愛い (かわいい): niedlich, süß, reizend, entzückend, nett, schön
セーター: Pullover, Strickjacke
椅子 (いす): (1) Stuhl, Sessel, (2) Stelle, Stellung, Sitz, Position, Amt
飴 (あめ): (1) (mn) Bonbon, (2) Verlockung, Lockmittel, (3) Bernsteinfarbe (Abk.)
伯父さん (おじさん): (1) ein Mann, (2) mein Herr!, Onkel (Anrede für den Onkel)
ペット: (1) Schoßtier, Haustier, (2) Liebling, Schatz
痛い (いたい): (1) weh tun, schmerzen, (2) schmerzhaft, weh, stechend
毎晩 (まいばん): jeder Abend, jeden Abend, allabendlich, jede Nacht, allnächtlich
車 (くるま): (1) Rad, (2) Wagen, Auto, Karren, Fuhrwerk, Gefährt, Wagon, Taxi
交番 (こうばん): (1) Wechseldienst, Wechselschicht, (2) abwechselnde Übernahme eines Amtes, (3) Polizeiwache, Polizeiposten, (4) Wechsel, Polwechsel (bei Strom und Magnetismus)
背広 (せびろ): Anzug
然して (そして): und, dann
其れから (それから): (1) danach, dann, darauf, (2) seitdem, seither, (3) und
お休みなさい (おやすみなさい): Gute Nacht!
夕方 (ゆうがた): Abend, am Abend
甘い (あまい): (1) süß, lieblich, (2) schwach gesalzen, (3) süßlich duftend, wie Honig duftend, (4) verführerisch, (5) nicht streng,  (zu) nachsichtig, nicht ernsthaft, (6) ungenügend, (7) zu optimistisch, einfach, einfältig, sentimental, (8) locker lose, stumpf
終わる (おわる): (1) enden, zu Ende gehen, zu Ende kommen, zum Abschluss kommen, (2) beenden, (3) fertig ….
デパート: Kaufhaus, Warenhaus
此の (この): dies, diese, das … hier
帰る (かえる): (1) zurückgehen, zurückkommen, heimkehren, heimkommen, nach Hause gehen, nach Hause kommen, (2) weggehen, (3) umkehren, sich umwenden, kehrt machen, zurückkehren
ハンカチ: Taschentuch
カップ: (1) Tasse, Becher, (2) Pokal, Trophäe, (3) Maßbecher, (4) Körbchen (eines BH)
瓩 (キログラム): Kilogramm
良く (よく): (1) gut, ausführlich, genau, exakt, (2) gut, geschickt, (3) nett, freundlich, (4) normalerweise, gewöhnlich, (5) besser
二十歳 (はたち): (1) 20 Jahre (alt), Alter von zwanzig Jahren, (2) 20
此れ (これ): (1) dies, das hier, (2) jetzt, (3) diese Person
ポケット: (1) Tasche, Jackentasche, Hosentasche, (2) Tasche (eines Poolbillard-Tisches), (3) Abstand zwischen erstem und dritten Pin bzw. erstem und zweiten Pin, (4) Situation, zwischen Wettbewerbern eingeschlossen zu sein, dass man nicht überholen kann, (5) finanzielle Ressourcen
点ける (つける): (1) anzünden, anmachen, anstellen, anknipsen, (2) einschalten, anschalten
困る (こまる): (1) in Schwierigkeiten sein, ratlos sein, (2) schlimm dran sein, leiden, (3) verlegen sein, in Verlegenheiten sein
カレンダー: Kalender
家 (うち): (1) Haus, Heim, Wohnung, (2) Zuhause, Familie, (3) unser
一 (いち): eins, eins, 1 (Ziffer in Dokumenten)
手 (て): (1) Hand, (2) Arm, (3) Tatze, Pfote, (4) Mittel, Weg, Mittel und Wege, Methode, Art und Weise, Kunstgriff, (5) Handschrift, (6) Griff, (7) Hände, Arbeitskräfte
角 (かど): Kado, (1) Winkel, Ecke, (2) Straßenecke, (3) Kantigkeit, Unvollkommenheit, (4) dicker Teil eines Schwertrückens, (5) Blickpunkt
然し (しかし): aber, jedoch, doch, indessen, allein
語 (ご): (1) Wort, (2) Sprache
再来年 (さらいねん): übernächstes Jahr
お金 (おかね): Geld, Münze, Vermögen
並ぶ (ならぶ): (1) nebeneinander stehen, in einer Reihe stehen, sich anstellen, anstehen, (2) parallel sein, (3) gleichrangig sein
出来る (できる): (1) können, vermögen, fähig sein, möglich sein, (2) fertig werden, fertig sein, bereit sein, (3) gemacht werden aus, angefertigt, gebaut, fabriziert, (4) wachsen, hervorbringen, (5) geschehen, sich ereignen, entstehen, (6) geboren werden, bekommen (ein Kind), (7) anbauen, gewinnen, (8) fähig sein, gut sein
旅行 (りょこう): Reise, Ausflug, Exkursion, Tour, reisen, eine Reise unternehmen, eine Tour machen
万年筆 (まんねんひつ): Füllfederhalter, Füllhalter, Füller
牛肉 (ぎゅうにく): Rindfleisch, Rind
晩 (ばん): (1) Abend, (2) Nacht, am Abend, abends
鍵 (かぎ): (1) Schlüssel, (2) Schloss, Türschloss, (3) Schlüssel, Lösung, Der Schlüssel(Roman von Tanizaki Jun’ichirō; 1956)
色々 (いろいろ): verschieden, verschiedenartig, allerlei, mannigfaltig, vermischt, bunt, viel, vielerlei, Verschiedenartigkeit, Mannigfaltigkeit, Vielerlei
引く (ひく): (1) ziehen, führen, (2) abziehen, (3) nachschlagen, (4) sich etw. zuziehen (eine Erkältung etc.), (5) zitieren, (6) installieren, (7) spannen (ein Seil), (8) einfetten, einölen, (9) bewässern, (10) zurückziehen, abziehen (Truppen), (11) abziehen, subtrahieren, minus
丸い (まるい): (1) rund, kugelrund, (2) kreisförmig, zirkular, (3) kugelförmig, sphärisch, (4) ohne Kanten, geschwungen, voll, (5) ruhig, friedlich, harmonisch, nicht widerspenstig
誰か (だれか): jemand, irgendjemand
鳥 (とり): (1) Vogel, (2) Huhn, (3) Vogelfleisch, Hühnerfleisch
頼む (たのむ): (1) bitten, eine Bitte an jmdn. richten, ersuchen, flehen, (2) anvertrauen, beauftragen, (3) bestellen
吸う (すう): (1) einatmen, aspirieren, (2) einsaugen, lutschen, (3) rauchen, (4) aufwischen, aufsaugen lassen, (5) küssen, (6) anziehen, an sich heranziehen
トイレ: Toilette
子供 (こども): (1) Kind, Säugling, Baby, Kleinkind, Junge, Mädchen, (2) eigenes Kind, Abkömmling, Spross
中 (ちゅう): (1) Inneres, Innenseite, die innere Seite, (2) Zentrum, Mitte, (3) Hälfte, halber Weg, (4) während, innerhalb
度 (ど): (1) Grad, °C, (2) …mal, (3) Maß, Grenze, Mäßigkeit
日曜日 (にちようび): Sonntag, am Sonntag
他 (ほか): (1) anderer Ort, (2) außen, (3) anderer, jemand anderes, (4) etw. anderes, (5) Übersteigen eines Limits, anderer, jmds. anderen
ノート: (1) Heft, Notizbuch, (2) Notizen, Mitschrift, (3) Note
何れ (どれ): welcher, welches
居る (いる): (1) sein, da sein, vorhanden sein, sich befinden, existieren, stehen, liegen, sitzen, (2) wohnen, leben, sich aufhalten, bewohnen
習う (ならう): (1) lernen, studieren, Unterricht nehmen, (2) üben
三日 (みっか): (1) dritter (Tag eines Monats), (2) drei Tage lang
有名 (ゆうめい): Berühmtheit, Bekanntheit, Namhaftigkeit, Renommiertheit, berühmt, bekannt, namhaft, renommiert
咖哩 (カレー): (mn) Curry (Gewürz), Haskell Brooks Curry (US-amerik. Mathematiker und Logiker; 1900–1982), (1) (mn) Curry (Gewürz), (2) Curryreis (Gericht), Calais (wichtige Hafenstadt in Nordfrankreich)
昨日 (きのう): gestern, gestern, der gestrige Tag
出口 (でぐち): Ausgang, Ausfahrt, Auslass, Deguchi
お姉さん (おねえさん): ältere Schwester
赤 (あか): rot, (1) Rot, rote Farbe, (2) Kommunist, Roter, (3) letzter, (4) Korrekturen, (5) vollkommen (nackt, fremd etc.), rote Färbung, Röte
会社 (かいしゃ): (1) Firma, Unternehmen, Gesellschaft (wie z.B. Handelsgesellschaft etc.), (2) Gesellschaft, Organisation, Verein
悪い (わるい): (1) hässlich, schlecht aussehen, (2) schlecht, minderwertig, niedrig, grob, nicht gut, (3) böse, schlecht, unmoralisch, ungehörig, schädlich, (4) unnormal, krank, unwohl, (5) kaputt, nicht funktionierend, (6) schlecht, unbeholfen, ungeschickt, plump, (7) unglückverheißend, unglücklich, (8) bösartig, von schlechter Natur, (9) verdorben, schlecht geworden (Nahrungsmittel), (10) unangenehm, negativ, unliebsam, lästig, (11) bedauerlich, zu entschuldigen
お巡りさん (おまわりさん): Polizist, Streifenpolizist (informeller, freundlicher Ausdruck)
一寸 (ちょっと): (1) einen Moment, einen Augenblick, ein Weilchen, (2) ein wenig, ein bisschen, etwas, leicht, (3) mal, (4) bitte, vielleicht, (1) einen Moment, einen Augenblick, ein Weilchen, (2) ein wenig, ein bisschen, etwas, geringfügig, leicht, (3) mal, (4) bitte, vielleicht
風 (かぜ): (1) Wind, Lüftchen, Windhauch, Brise, (2) Sturm, Sturmwind, Orkan, Wirbelwind, Windstoß, Bö, (3) Luftzug, Zug, (4) Wind, Stimmung, (5) …–Haltung (als Suffix)
三つ (みっつ): Mawashi (Lendentuch der Sumōringer), drei, drei Stück, drei Jahre alt, drei
鉛筆 (えんぴつ): Bleistift, (mn) Blei, Schreibstift
二日 (ふつか): (1) zweiter (Tag eines Monats), (2) zwei Tage
飛行機 (ひこうき): Flugzeug
左様なら (さようなら): (1) Auf Wiedersehen!, (2) Leben Sie wohl!
持つ (もつ): (1) haben, besitzen, innehaben, verfügen, (2) in der Hand halten, festhalten, halten, (3) hegen, pflegen, unterstützen, (4) tragen, bei sich haben, (5) auf sich nehmen, übernehmen, verantwortlich sein, bekleiden, (6) halten, dauern, währen, überstehen, überleben
売る (うる): (1) verkaufen, vertreiben, veräußern, absetzen, anbieten, feilhalten, (2) verraten, (3) gewinnen, (4) anfangen
金曜日 (きんようび): Freitag
為る (する): (1) tun, machen, verrichten, (2) ausüben, treiben (Beruf, Sport), (3) kosten, (4) haben, (5) verstreichen (Zeit), in (temporal), (6) entscheiden, im Begriff sein, (7) sein
午後 (ごご): (1) zweite Tageshälfte, Zeit von 12 Uhr mittags bis 0 Uhr, (2) Nachmittag, Zeit von 12 Uhr mittags bis Abend, am Nachmittag
鼻 (はな): (1) Die Nase (Roman von Akutagawa Ryūnosuke; 1916), (2) Die Nase (Oper von Dmitri Schostakowitsch nach Gogols; UA: 1930), (1) Nase, Rüssel, Schnauze, (2) Geruchssinn, (3) Stolz, Einbildung
分 (ふん): Minute
来る (くる): (1) kommen, ankommen, herankommen, eintreffen, besuchen, aufsuchen, vorsprechen, sich nähern, herkommen, fällig werden, ablaufen, verfallen, (2) herüberkommen, überliefert werden, (3) stammen, herstammen, herrühren, entstehen, sich ergeben zurückzuführen sein
西 (にし): Westen, Nishi
立つ (たつ): (1) aufstehen, sich aufrichten, sich auf die Beine stellen, (2) aufgehen, aufsteigen, in die Luft steigen, (3) errichtet werden, (4) abfahren, abgehen, abreisen, aufbrechen, (5) verdampfen, verdunsten, (6) eine Erektion haben
降りる (おりる): (1) herabsteigen, hinabsteigen, heruntersteigen, herunterkommen, (2) aussteigen (aus einem Gefährt, an einem Ort), absteigen (z.B. von einem Fahrrad), (3) sich von einem hohen Ort zurückziehen, (4) geben, ausgeben, verkünden (eine Anweisung, eine Entscheidung), (5) landen, (6) fallen, (7) (aus dem Geschäft) aussteigen, (8) sich absetzen, entstehen (z.B. Reif od. Tau), (9) heraushängen, (10) Tusche reiben
動物 (どうぶつ): Tier
緑 (みどり): (1) Grün, (2) Schwarz (Haare)
辺 (へん): (1) Gegend, Region, Umgebung, Nähe, (2) Seite, (3) Seite, Kante, (4) Zweig (einer Messbrücke)
閉める (しめる): schließen, zuschließen
百 (ひゃく): hundert, einhundert
留学生 (りゅうがくせい): im Ausland Studierender, ausländischer Student
要る (いる): brauchen, benötigen, nötig sein, nötig haben, erfordern, bedürfen
六つ (むっつ): sechs, 6, (1) sechs Stück, (2) sechs Jahre alt
真っ直ぐ (まっすぐ): (1) geradeaus, gerade, direkt, aufrecht, (2) aufrichtig, offenherzig, rechtschaffen, ehrlich
一日 (ついたち): erster Tag des Monats nach dem Mondkalender, erster Tag des Monats, Monatserster, (1) erster Tag eines Monats, Monatserster, (2) Monatsanfang, (3) 1. Januar, Neujahrstag, Neujahr
締める (しめる): (1) zubinden, umbinden, festschnüren, zusammenschnüren, (2) anziehen (z.B. Schraube od Wasserhahn), strenger werden, fester anfassen, (3) zusammenrechnen
茶わん (ちゃわん): (1) Teeschale, henkellose Teetasse, (2) Reisschale, Schüssel, (3) Keramik, Keramikgefäß, (4) in einer Schüssel mit Deckel servierte, leichte Vorsuppe, (5) Tenmoku-Teeschale, (6) unbehaarte weibliche Scham
不味い (まずい): (1) nicht schmecken, unappetitlich, (2) ungeschickt, schlecht, (3) hässlich
結構 (けっこう): (1) (2) (3) , herrlich, glänzend, gut, exzellent, wunderbar, ausgezeichnet
手紙 (てがみ): Brief
電気 (でんき): (1) elektrisches Licht, (2) Elektrizität, Strom
小さな (ちいさな): (1) klein, gering, winzig, wenig, (2) fein, delikat, zart, (3) jung, (4) geringfügig, kleinlich, schwach
言葉 (ことば): (1) Sprache, (2) Muttersprache, (3) Wort, (4) Dialekt, Mundart, (5) Ausdruck, Sprechweise, Diktion, Wortlaut, Wortwahl
賑やか (にぎやか): (1) lebhaft, laut, gesellig, fröhlich, (2) geschäftig, belebt
厚い (あつい): (1) dick, breit, tief, groß, (2) aufrichtig, herzlich, warmherzig, liebevoll, (3) gnädig, (4) schwer (eine Krankheit), (5) reich, wohlhabend, (6) frech, schamlos, unverschämt, schändlich
此処 (ここ): (1) hier, dieser Ort, (2) dies
町 (まち): (1) Straße, Block, (2) Flächen-chō, Längen-chō, (1) Stadt, (2) Einkaufsstraße, Einkaufsviertel, (3) Stadtkommune, (4) Stadtviertel (kleinere Einheit als ku oder shi), (5) Häuserblock, (6) Teil eines Palastes oder Herrenhauses, (7) Klasse, Rang, Stand, (8) Markt, Marktplatz, (9) Geschäft, Laden, (10) aufgeteiltes Feld, Teil eines Feldes
一人 (ひとり): eine Person, (1) ein, einer, eine, eine Person, ein Mensch, (2) alleine, für sich, (1) alleine, (2) nicht nur, (3) Single
も: (1) auch, ebenso, und auch, nicht nur …, sondern auch …, sowie, sowohl … als auch …, (2) auch, schon selbst, sogar, (3) (mit Verneinung) weder … noch …, (4) wenn auch, auch wenn
今日 (きょう): (1) heute, (2) heutzutage, in der heutigen Zeit, heute, dieser Tag, heutiger Tag
コート: (1) Mantel, (2) Beschichtung, Tennisplatz, Volleyballplatz
渡る (わたる): (1) sich erstrecken, gehen von … bis …, (2) gehen bis, sich erstrecken bis …, (3) betreffen, (1) überschreiten, überqueren, (2) migrieren, einwandern, auswandern, (3) (in jmds. Hände) übergehen, (4) verteilt werden, (5) durchs Leben gehen
此方 (こちら): (1) diese Richtung, dieser Weg, (2) dieser Ort, (3) diese Person, (4) dies hier, (5) ich, wir
お兄さん (おにいさん): älterer Bruder
二 (に): zwei, zwei, 2, zwei (in Dokumenten)
米 (メートル): (mn) Meter (Einheit des Meter-Kilogramm-Sekunde-Systems; Zeichen: m)
長い (ながい): (1) lange, lang andauernd, ausgedehnt, (2) ewig (Zeit), (1) lang, (2) länglich, lange
借りる (かりる): (1) sich (von jmdm. etw.) ausleihen, entleihen, leihen, (2) mieten, pachten, chartern, (3) sich verschulden, Schulden machen, (4) bekommen (Hilfe, einen Rat etc.)
忙しい (いそがしい): gehetzt, beschäftigt, geschäftig, (1) viel zu tun haben, beschäftigt sein, in Anspruch genommen sein, sich beschäftigen, (2) beschäftigt, geschäftig, rührig
ネクタイ: Krawatte, Schlips, Binder
着る (きる): (1) anziehen, tragen, ankleiden, bekleiden, (2) angeklagt sein, beschuldigt werden, (3) etwas auf sich nehmen
済みません (すみません): (1) Entschuldigen Sie bitte!, (2) Es tut mir leid!, (3) Danke!
成る (なる): (1) werden, (2) sich entwickeln zu …, sich verwandeln zu …, (3) jmdn. spielen, (4) fertig werden, (5) bestehen aus, (6) erreichen, (7) betragen, machen, (8) dienen, zu benutzen sein, (9) vergehen, (10) befördern (eines Steins)
被る (かぶる): (1) aufsetzen (einen Hut, eine Maske), (2) aufhaben, tragen (in der Form kabutteiru), (3) den Kopf bedecken, über den Kopf ziehen, (4) übergossen werden, begossen werden, (5) übernehmen (eine See), (6) bedeckt sein, (7) auf sich nehmen (Schuld), (8) einem zuteilwerden, gewährt bekommen, erhalten (etw. Angenehmes), (9) Schleier bilden, (10) überlagern, übertönen, (11) sich überschneiden, sich überlappen, (12) gleichtun, übernehmen, nachmachen, (13) enden (eines Theaterstücks), (14) ein volles Haus bekommen (beim Yose), (15) scheitern, fehlschlagen, missglücken
二つ (ふたつ): (1) zwei, (2) zwei Jahre alt
テレビ: (1) Fernsehen, (2) Fernseher (Abk.)
答える (こたえる): (1) antworten, beantworten, Antwort geben, entgegnen, erwidern, (2) lösen
時間 (じかん): (1) Zeit, (2) Stunde, (3) Termin, Uhrzeit, (4) Unterrichtsstunde, (5) Arbeitszeit, Dienststunde
北 (きた): Norden, Kita (einer von 23 Stadtbezirken in Tōkyō), Kita
学生 (がくせい): (1) Student, (2) Schüler
学校 (がっこう): Schule, Lehranstalt, Bildungseinrichtung, Akademie, Seminar
郵便局 (ゆうびんきょく): Postamt
川 (かわ): Fluss, Strom, Bach
多い (おおい): viel, zahlreich, groß, oft, häufig
段々 (だんだん): (1) (2) 
知る (しる): (1) wissen, lernen, fühlen, bemerken, verstehen, folgern, herausbekommen, (2) kennen, bekannt werden, jmds. Bekanntschaft machen, erfahren, kennen lernen, gehört haben, (3) erfahren, durchmachen
卵 (たまご): (1) Ei, Laich, (2) Hühnerei, (3) Person, die in der entwicklung zu etw. ist, (4) Entstehungszustand, Embryonalzustand (die Schreibung 玉子 beschränkt sich auf den Kontext, dass Hühnereier zum Kochen benutzt werden)
其方 (そちら): (1) dort, diese Richtung, (2) du, Sie, (1) diese Richtung, (2) dort, (3) der Ort da, (4) die Person da, (5) das da, (6) die Seite da, (7) du, (8) Sie, (9) Ihre Familie, (1) diese Richtung, (2) du, Sie (Bezeichnung für jmdn. jüngeren bzw. untergeordneten)
日 (ひ): (1) Sonne, (2) Sonnenlicht, Sonnenstrahl, (3) Tag, (4) Datum
週間 (しゅうかん): eine Woche
机 (つくえ): (1) Schreibtisch, Arbeitstisch, (2) Esstisch
何時も (いつも): immer
薄い (うすい): (1) dünn, (2) schwach, wässerig, leicht, hell, hellfarbig, trüb
歌う (うたう): (1) singen, summen, (2) dichten, (3) rezitieren, (4) jmdn. in den Himmel loben, (5) in Deutlichkeit über etw. sprechen
浴びる (あびる): (1) sich baden in …, (2) baden in …, in … gebadet sein, übergießen mit …, (3) übergossen werden mit …, bedeckt sein mit …, (4) überschüttet werden mit …, … ausgesetzt sein, … erleiden, von etw. in großer Menge umgeben sein, (5) in großen Mengen trinken (Alkohol)
片仮名 (かたかな): Katakana (eine der beiden japan. Silbenschriften)
背 (せ): (1) Rücken, (2) Größe, Körpergröße, (3) Rückseite, (4) Bergrücken, Grat, (5) Bogenrücken (Außenseite des Bogens)
生まれる (うまれる): (1) geboren werden, zur Welt kommen, das Licht der Welt erblicken, (2) resultieren, ins Leben gerufen werden, ein Produkt von … sein
バター: Butter
疲れる (つかれる): (1) müde werden, ermüden, ermatten, (2) verbraucht sein
ナイフ: Messer
覚える (おぼえる): (1) lernen, erlernen, auswendig lernen, einpauken, einstudieren, einprägen, (2) trainieren, (3) sich erinnern, sich entsinnen, wissen, sich merken, (4) fühlen, empfinden, gewahr werden, (5) anderen so erscheinen, (6) bewusst werden, verstehen, (7) sich erinnern, (8) ähnlich sein
白 (しろ): (1) Weiß, weiße Farbe, (2) Unschuld
顔 (かお): (1) Gesicht, Angesicht, Antlitz, (2) Person, (3) Gesichtsform, Gesichtszüge, Miene, Aussehen, Gesichtszüge, Physiognomie, (4) Ansehen, Ehre, Ruf, guter Ruf, (5) Einfluss, (6) Repräsentant, Vertreter nach außen, (7) Oberfläche
石鹸 (せっけん): Seife
病気 (びょうき): (1) Krankheit, Leiden, Beschwerde, (2) Schwäche, Sucht, krank
弟 (おとうと): (1) jüngeres Geschwister, (2) jüngerer Bruder, jüngere Schwester, (1) jüngerer Bruder, (2) Schwager, Ehemann der jüngeren Schwester, (3) jüngerer Bruder des Ehegatten, (4) jüngeres Geschwister
大学 (だいがく): (1) Universität, Hochschule, Akademie, (2) zentrale Ausbildungstätte für Beamten (nach dem Ritsuryō-System), Das Große Lernen (eine der heiligen Schriften des Konfuzianismus)
年 (とし): (1) Jahr, (2) Alter, … Jahre alt
伯母さん (おばさん): Tante (Anrede)
入れる (いれる): (1) hineintun, füllen, einsetzen, einstellen, einnehmen, einpacken, (2) einlegen, hinzufügen, (3) einweisen, (4) einschließen, (5) zubereiten, (6) hineinstecken, einlassen, (7) aufnehmen, fassen, unterbringen, (8) annehmen, erlauben, billigen, (9) anstellen, engagieren, (10) Tee zubereiten, (11) abstimmen, seine Stimme abgeben
縦 (たて): (1) Länge (im Gegensatz zur Breite), Höhe, (2) Tiefe (im Gegensatz zur Breite), (3) Top-Down-Beziehung, vertikale Beziehung, (4) Nord-Süd-Richtung, geographische Länge, (5) Kette, Kettfaden (Abk.), in der Länge, längelang, Längen…, aufrecht, senkrecht, vertikal
軽い (かるい): (1) leicht, nicht schwer, (2) nicht beschwerlich, leicht, einfach, (3) leichtfertig, leichtsinnig, voreilig, frivol, (4) nicht belastend, ungefährlich, (5) unbedeutend, unwichtig, (6) winzig, gering, klein, (7) sanft, schwach, (8) beschwingt, leicht, lebhaft, (9) einfach, schlicht, leicht, bekömmlich
低い (ひくい): (1) niedrig, klein, flach, tief, (2) leise, (3) bescheiden, demütig, (4) niedrig, von niedriger Herkunft, gemein
こんな: so ein, solch ein
弾く (ひく): spielen (ein Saiten‑ od. Tasteninstrument)
古い (ふるい): (1) alt, altertümlich, (2) langjährig, sich über lange Zeit erstreckend, (3) altehrwürdig, althergebracht, (4) ehemalig, noch nicht reformiert, in der alten Version, (5) altmodisch, veraltet, altbacken, unmodern, abgestanden, abgenutzt, (6) alterserfahren, routiniert
ラジオカセット: Radio-Kassettenrekorder
消える (きえる): (1) ausgehen, erlöschen, (2) schmelzen, (3) verschwinden, vergehen, (4) verblassen, (5) abgehen
起きる (おきる): (1) sich aufrichten, sich erheben, (2) aufstehen, das Bett verlassen, aus dem Bett kommen, (3) aufwachen, wach werden, (4) auf sein, aufbleiben, nicht schlafen, (5) passieren, sich ereignen, auftreten, entstehen
忘れる (わすれる): (1) vergessen, verschwitzen, (2) nicht mehr denken, sich aus dem Sinn schlagen, (3) liegen lassen, verlegen, verbummeln
今晩 (こんばん): heute Abend, heute Nacht
一緒 (いっしょ): (1) Zusammensein, (2) Gleichzeitigkeit, Gleichartigkeit
頁 (ページ): (1) Buchseite, Seite, (2) Seite, Page (der Speicherverwaltung), (3) Webseite (Abk.)
ラジカセ: Radio-Kassettenrekorder
何の (どの): welcher, welch, welche
詰らない (つまらない): (1) langweilig, uninteressant, (2) wertlos, geringfügig, unbedeutend, nichtswürdig, (3) dumm, albern, blöde, blödsinnig, (4) unrentabel, wenig einträglich, unbefriedigend
使う (つかう): (1) benutzen, gebrauchen, verwenden, sich bedienen, (2) einstellen, anstellen, beschäftigen, (3) bändigen, manipulieren, (4) handhaben, bedienen, behandeln, (5) durchführen, tun, machen, (6) aufwenden, verbrauchen, konsumieren, ausgeben, (7) treiben
お祖母さん (おばあさん): Großmutter, Oma, alte Frau, Greisin
お腹 (おなか): (1) Bauch, Magen (höfl. für hara腹; im Mittelalter frauenspr.), (2) Leib, (3) Mahl, Mahlzeit, (4) Watte, Seide
上着 (うわぎ): (mn) Sakko, Jacke, Kostümjacke, Jacke
時々 (ときどき): (1) manchmal, bisweilen, hin und wieder, gelegentlich, (2) jeweilige Zeit, jeweilige Saison
若い (わかい): (1) jung, jugendlich, halbwüchsig, heranwachsend, blühend, (2) unerfahren, reif, grün, nicht reif hinter den Ohren, (3) niedrig (Zahl)
一つ (ひとつ): (1) ein, ein Stück, eine …, (2) derselbe, dasselbe, (3) einerseits, zum einen, zum Teil, (4) nicht einmal, nicht ein einziges (mit Verneinung), (5) nur, nur ein wenig, (6) ein Jahr alt
国 (くに): (1) Land, Landschaft, (2) Staat, Reich, (3) Geburtsort, Heimat, Heimatnation, (4) Nationalität, (5) Provinz
五日 (いつか): (1) fünfter (Januar etc.), (2) fünf Tage (lang)
文章 (ぶんしょう): (1) Aufsatz, Abhandlung, Essay, (2) Text, (3) Satz, (4) Schreibstil, (5) Prosa
書く (かく): (1) schreiben, verfassen, (2) malen
待つ (まつ): (1) warten, entgegensehen, harren, sich freuen auf …, (2) erwarten, ersehnen, sich versprechen, (3) sich verlassen auf …, bauen auf …, rechnen auf …, vertrauen auf …, zählen auf …, (4) behandeln, begegnen, umgehen mit …
中 (なか): Naka, (1) Inneres, Innenseite, die innere Seite, (2) Zentrum, Mitte, (3) Hälfte, halber Weg, (4) während, innerhalb, (5) Mittelschule
妹 (いもうと): (1) jüngere Schwester (des Sprechers), (2) freundliche Anrede eines Mannes gegenüber einer Frau, z.B. gegenüber der Ehefrau oder Geliebten, (3) Anrede zwischen Frauen
お酒 (おさけ): Sake, Alkohol (höfl.)
楽しい (たのしい): (1) angenehm, vergnüglich, lustig, glücklich, fröhlich, froh, erfreulich, zufrieden, (2) satt, (3) reich, wohlhabend
灰皿 (はいざら): Aschenbecher
貴方 (あなた): du, Sie
公園 (こうえん): (1) öffentlicher Park, öffentlicher Garten, öffentliche Anlage, (2) Nationalpark, Naturschutzgebiet
はい: (1) Ja!, (2) Bitte schön!
台 (だい): (1) Gestell, Ständer, (2) Plattform, (mn) Podest, Sockel, (3) Plateau, Niveau
十日 (とおか): zehnter (Tag eines Monats), zehn Tage
後ろ (うしろ): (1) Rückseite, Hinterseite, (2) rückwärtige Richtung, hinten, (3) Rücken, (4) nachgeordnete Richtung, Nachfolge in der Reihenfolge, (5) hinterer Bühnenassistent, (6) Hintergrundmusik, (7) Zukunft, (8) Schleppe eines Kimono
曲がる (まがる): (1) sich biegen, sich beugen, sich krümmen, sich neigen, nachgeben, (2) ein Biegung machen, eine Wendung machen, sich wenden, sich winden, sich schlängeln, (3) abbiegen, einbiegen, (4) krumm sein, gekrümmt sein, (5) vom geraden Weg abweichen, verschroben werden
午前 (ごぜん): (1) erste Tageshälfte, Zeit von 0 Uhr bis 12 Uhr mittags, (2) Morgen, Vormittag, Zeit von Sonnenaufgang bis 12 Uhr mittags, am Morgen, morgens
右 (みぎ): (1) rechte Seite, die Rechte, rechts, (2) Westen (wenn man nach Süden blickt), (3) höherer Rang, höhere Stellung (in der Han-Zeit), (4) Hervorragendheit, (5) bei zwei fast gleichen Beamtenrängen der etwas niedrigere, (6) das Vorhergehende, das vorher Geschriebene (wenn man in senkrechten von rechts nach links fortschreitenden Zeilen schreibt), (7) die Rechte, die Rechten, der rechte Flügel einer Partei, (8) rechte Flanke, rechter Flügel
年 (ねん): (1) Jahr, (2) Dienstalter, Dienstzeit, Lehrzeit, Klasse
早い (はやい): früh, frühzeitig, frühmorgens, verfrüht, vor der Zeit, (1) schnell, geschwind, behände, reißend, (2) rasch, fix, hurtig, prompt, gleich, sofort
青い (あおい): (1) blau, (2) grün (z.B. Ampel, Blattwerk), (3) blass, bleich, (4) unerfahren, unreif, grün
外 (そと): (1) Außengebiet, Gebiet außerhalb von etw, (2) das Freie, Exterieur, (3) Außenseite, Äußeres, (4) anderer Ort, (5) Außenwelt
入口 (いりぐち): Eingang, Einfahrt, Einlass, Zugang
さあ: los, nun, also, tja
無くす (なくす): jmdm. sterben, jmdm. durch den Tod geraubt werden, (1) verlieren, verlustig gehen, einbüßen, verwirken, beraubt werden, (2) abschaffen, sich abgewöhnen
橋 (はし): (1) Brücke, (2) Verbindung, Vermittlung
方 (かた): Richtung, Person, Art und Weise
窓 (まど): (1) Fenster, (2) Window, Fenster
あのう: (1) ähm, (2) und …, also…, nun …, also …, äh …
奥さん (おくさん): (1) jmds. anderen Ehefrau, verheiratete Frau, (2) Ehefrau eines Daimyō oder Höflings, (3) gnädige Frau, meine Dame
散歩 (さんぽ): Spaziergang, spazieren gehen, einen Spaziergang machen
塩 (しお): (1) Salz, (2) salziger Geschmack, Salzigkeit, (3) Mühen und Sorgen in der vergänglichen Welt
豚肉 (ぶたにく): Schweinefleisch
先生 (せんせい): (1) Lehrer, Lehrerin, Lehrmeister, Meister, Schulmeister, Doktor, (2) in Kunst und Wissenschaft fortgeschrittene Person, (3) respektvolle Anrede für Lehrer, Professoren, Ärzte, Künstler, Rechtanwälte etc., (4) Meister, Alter, Typ (freundlich oder um sich über jmdn. lustig zu machen, verwendet), (5) früher als jmd. selbst geborene Person, Älterer (ist die ursprüngl. Bedeutung)
働く (はたらく): (1) arbeiten, schaffen, sich beschäftigen, sich betätigen, (2) sich bemühen, (3) begehen, verüben, (4) angestellt sein, bekleiden, verwalten, (5) fungieren, wirken, tätig sein als, (6) funktionieren, laufen
出す (だす): (1) herausholen, herauslegen, hinausstellen, herausnehmen, (2) ausstrecken, hinausstrecken, (3) gehen lassen, schicken, (4) abschicken (einen Brief), aufgeben, (5) einreichen, abgeben, (6) einsetzen, (7) veröffentlichen, herausgeben, herausbringen, (8) servieren, anbieten, (9) bezahlen, (10) zeigen, (11) aushängen, aufgeben, verursachen
教室 (きょうしつ): (1) Klassenzimmer, Unterrichtsraum, Hörsaal, Auditorium, Aula, (2) Abteilung, Seminar, (3) Kurs
スカート: Rock
粁 (キロメートル): Kilometer
下手 (へた): (1) Ungeschicktheit, Unbegabtheit, (2) ungeschickte Person, unbegabte Person, (3) Gedankenlosigkeit, Verantwortungslosigkeit, ungeschickt, schlecht, auf ungeschickte Weise, ungeschickt
足 (あし): (1) Bein, (2) Fuß (eines Tieres oder Menschen), (3) Fuß, Ständer, (4) unterer Teil eines Kanji, (5) Kreuzungspunkt, (6) Gehen, (7) Verkehrsmittel, (8) Fortschreiten, (9) Geld (z.B. in der Form o・ashi), (10) Klebrigkeit von Teig, (11) Ashi・kanamono (Metallbeschlag für das Band, mit dem die Schwertscheide am Gürtel befestigt wird), (1) Fuß, Bein, Pfote, Huf, (2) Bein einer Hose, (3) Tiefgang (eines Schiffes), (4) Stiel, (5) Schritt, Laufen, (6) Transportmittel, (7) Verderblichkeit von Lebensmitteln, (8) Reichweite, (9) Absatz, Umsatz, Nachfrage, (10) Standfestigkeit
牛乳 (ぎゅうにゅう): (1) Milch, Kuhmilch, (2) Milch und verarbeitete Milch
では: also, dann, also dann
珈琲 (コーヒー): Kaffee
上 (うえ): Ue, (1) oben, auf, über, (2) höhere Position, höherer Rang, (3) oberer Teil, Spitze, (4) Oberseite, obere Seite, Oberfläche, (5) Gipfel, Kopf, (6) außerdem, auch noch, darüber hinaus, oben, höher, ober, über, jenseits
誰 (だれ): (1) wer, welcher, (2) jemand, irgendein, (3) jeder, jedermann, alle und jede, wem, wessen
熱い (あつい): heiß, warm (Flüssigkeiten, Gegenstände, Leidenschaft)
煩い (うるさい): (1) laut, lärmend, (2) störend, lästig, aufdringlich, (3) nervtötend, nervig
もう一度 (もういちど): noch einmal, wieder
パン: Pfanne, Bratpfanne, Kameraschwenk, Pan, Faun (Gott der Hirten und des Viehs)
字引 (じびき): Wörterbuch, Kanjiwörterbuch
少し (すこし): (1) ein wenig, ein bisschen, etwas, (2) einen Moment, einen Augenblick, (3) ein kleines Stück (Weges), (4) überhaupt nicht (mit Verneinung)
エレベーター: Fahrstuhl, Aufzug, Lift, (1) Aufzug, Fahrstuhl, Lift, (2) Höhenruder
薬 (くすり): (1) Arznei, Medizin, Medikament, Heilmittel, Mittel, Pulver, Trank, (2) Droge, Arzneimittel, Chemikalien, (3) Glasur, (4) Nutzen, Beitrag, Belehrung
所 (ところ): (1) Ort, Platz, Stelle, (2) ungefähr, Tokoro, (1) Ort, Platz, Stelle, (2) Zuhause, (3) Adresse, (4) Gebiet, Ort, (5) Punkt, (mn) Teil, Passage, (6) freier Platz, Raum, (7) Zeit, Moment
同じ (おなじ): (1) gleich, derselbe, dieselbe, dasselbe, nämlich, identisch, (2) gleich, ähnlich, gleich, auf die gleiche Weise
砂糖 (さとう): Zucker
雨 (あめ): (1) Regen, (2) Regenwetter, (3) etw., das wie Regen fällt
細い (ほそい): Hosoi (ein Binsengewächs), Juncus setchuensis, (1) dünn, fein, schmal, schlank, eng, spitz, (2) wenig, (3) dünn, leise (z.B. Stimme)
閉まる (しまる): (1) sich schließen, zugehen, (2) sich straffen, sich anspannen, sich straff halten, (3) sparsam werden, sparsam wirtschaften, mäßig leben, mit etw. haushalterisch umgehen, (4) zu eng sein, drücken, sich schließen, zugehen
遠い (とおい): (1) weit, fern, weit entfernt, entlegen, (2) fern (Vergangenheit, Zukunft), (3) sehr unterschiedlich (Quantität, Situation), (4) entfremdet, nicht vertraut, (5) ohne Beziehung, (6) entfernt verwandt, (7) unbekannt, (8) nicht richtig funktionierend (Ohren, Augen, Bewusstsein), (9) schwerhörig sein, schlecht hören, (10) schlecht sehen, (11) besinnungslos, ohnmächtig
雑誌 (ざっし): Zeitschrift, Magazin, Journal
買う (かう): (1) kaufen, einkaufen, einhandeln, erstehen, besorgen, (2) sich einhandeln, sich zuziehen, auf sich ziehen, auf sich laden, (3) schätzen, anerkennen, gerecht werden
半 (はん): (1) Hälfte, Halbes, halb …, (2) ungerade Zahl
階 (かい): (1) Geschoss, Etage, Stockwerk, Stock, (2) geologische Schicht, (3) Amtsrang, Grad, (4) Treppe, Stufe, Leiter, (5) …tes Stockwerk, Zählwort für Stockwerke, (6) …ter Rang, Zählwort für Ränge
休み (やすみ): (1) Pause, Ruhe, (2) Urlaub, (3) Abwesenheit, Fehlen, (4) Ausruhen, Zu-Bett-Sein
左 (ひだり): Hidari, (1) linke Seite, links, (2) Linker, links, (1) links, linker, (2) link, rot
交差点 (こうさてん): (1) Kreuzung, (2) Schnittpunkt, Kreuzung, Kreuzungspunkt
地図 (ちず): Karte, Landkarte, Plan, Stadtplan, Atlas
弱い (よわい): (1) schwach, mild, leise, sanft, (2) schwächlich, gebrechlich, empfindlich, (3) schlecht, (4) etw. schlecht vertragen können, (5) mit Tendenz zu etw, mit Hang zu etw
鳴く (なく): singen, krähen, gackern, zwitschern, piepsen, krächzen, schnattern, kreischen, schreien, rufen, bellen, heulen, jaulen, knurren, miauen, muhen, meckern, brüllen, blöken, zirpen, schreien (Tierlaute)
皆さん (みなさん): meine Damen und Herren (etwas freundlicher als minasama皆様)
遣る (やる): (1) geben, schenken, (2) schicken, senden, (3) tun, machen, treiben, spielen, (4) sein, haben, schaffen als …, (5) trinken, (6) etwas für jmdn. tun
レコード: (1) Rekord, Höchstleistung, (2) Schallplatte, Langspielplatte, (3) Datensatz einer Datenbank
財布 (さいふ): Portemonnaie, Geldbeutel, Geldbörse
もう: (1) schon, bereits, inzwischen, (2) bald, (3) noch einmal, noch …, (4) mehr, weiter
ペン: (1) Füller, Federhalter, Füllfederhalter, (2) Stift, Schreibstift, Zeichenstift, (3) Schreiben, schriftstellerische Tätigkeit, (1) Arthur Penn (amerik. Theater‑ und Filmregisseur; 1922–), (2) William Penn (engl. Quäker, Gründer von Pennsylvania; 1644–1718)
肉 (にく): (1) Fleisch, (2) Fruchtfleisch, (3) Stempelkissen, Stempeltinte, (4) Dicke, Stärke, (5) Fleisch (der menschliche Körper mit seinen Begierden)
釦 (ボタン): (1) Knopf, (2) Taste, Knopf, Button
始まる (はじまる): (1) anfangen, beginnen, einsetzen, ausbrechen, (2) entstehen, entspringen, herrühren
嗚呼 (ああ): (1) ach!, ah!, o!, oh! (als Ausdruck der Emotion und Klage), (2) ach, entschuldigen Sie!, ach, hallo! (als direkte Anrede), (3) (als Antwort auf eine Entscheidungsfrage) ja, (4) (bzw.) nein (als Antwort auf eine verneinte Frage), (1) äh!, öh! (wenn man nach Worten sucht), (2) hm!, ehem! (wenn man sich räuspert), (3) ah! (wenn man den Mund weit aufmacht, z.B. bei einer ärztlichen Untersuchung)
其処 (そこ): dort, da, jener Ort, die Stelle da
八つ (やっつ): (1) acht, 8, (2) acht Jahre, acht, 8
月曜日 (げつようび): Montag
映画 (えいが): Film, Kino, Lichtspiel, Kinematograph, filmisch
吹く (ふく): (1) blasen, wehen, (2) ausatmen, (3) spielen (Blasinstrument), (4) austreiben (Knospen), (5) angeben, prahlen, (6) gießen, (1) ausstoßen, speien, ausspeien, herausschleudern, (2) blasen
四 (し): vier, 4
帽子 (ぼうし): Hut, Mütze
写真 (しゃしん): Fotografie, Foto, Aufnahme, Schnappschuss
個 (こ): (1) Individuum, eine Person, (2) jmd. selbst, (3) (als Suffix)Stück, Exemplar (Zählwort für kleinere Dinge, Äpfel, Eier, Schachteln, Bündel etc.)
英語 (えいご): Englisch, englische Sprache, englisch
万 (まん): alles, alle Sachen, Yorozu, (1) zehntausend, (2) Myriade
スプーン: Löffel
風邪 (かぜ): Erkältung, Grippe
もっと: mehr, noch, besser, länger, weiter
夏休み (なつやすみ): Sommerferien
男の子 (おとこのこ): Junge
ズボン: Hose
如何して (どうして): (1) wieso, warum, weshalb, weswegen, (2) wie, auf welche Weise
声 (こえ): (1) Stimme, Laut, Ton, Schrei, Ruf, (2) Tierstimme, Zirpen, Heulen, Bellen, Brüllen
其れ (それ): (1) das da, das, (2) der, die, das, (3) diese Zeit
毎年 (まいとし): jedes Jahr, jährlich
大使館 (たいしかん): Botschaft
時 (とき): (1) Zeit, Stunde, (2) Zeiten, Fall, Gelegenheit, Jahreszeit, (3) Moment, Augenblick, (4) Tempus, Zeit, Zeitform, (5) als, wenn
天気 (てんき): (1) Wetter, Witterung, schönes Wetter, (2) Laune
質問 (しつもん): Frage, Anfrage, Fragestellung, Erkundigung, Interpellation, fragen, eine Frage stellen, eine Frage aufwerfen, eine Frage anschneiden, eine Anfrage richten, interpellieren, sich erkundigen
辞書 (じしょ): Wörterbuch,  (obsol.)(mn) Diktionär
話 (はなし): (1) Rede, Gespräch, Unterhaltung, Besprechung, (2) Geschwätz, Geplauder, Gerede, Klatsch, (3) Geschichte, Erzählung, (4) Gerede, Gerücht, Hörensagen
勤める (つとめる): (1) arbeiten, seine Pflicht erfüllen, (2) spielen (eine Rolle), (1) angestellt sein, tätig sein, in Stellung sein, einen Posten innehaben, (2) sich der buddhistischen Lehre widmen, Buddhismus praktizieren, buddhistische Riten lernen, (3) auf sich achten, vorsichtig sein, sich schonen, (4) spielen (eine Rolle)
四日 (よっか): (1) vierter (Tag eines Monats), (2) vier Tage
上る (のぼる): (1) aufgehen, steigen, aufsteigen (Sonne, Rauch), (2) hinaufsteigen, hinaufgehen, besteigen, ersteigen, klettern (Hügel, Berg), (3) betragen, ausmachen, ergeben, sich belaufen, (4) aufsteigen, aufstreben, emporkommen, (5) aus der Provinz in die Hauptstadt gehen, (6) flussaufwärts gehen, den Fluss hinauf fahren, (7) eintreten, betreten (Palast, heilige Halle), (8) in aller Leute Mund sein, (9) aufgetischt werden
遊ぶ (あそぶ): (1) spielen, sich vergnügen, sich amüsieren, sich unterhalten, (2) faul sein, nichts tun, (3) nicht in Gebrauch sein, (4) einen Auslandstudienaufenthalt machen, (5) eine Reise machen, (6) ins Rotlichtviertel gehen, (7) arbeitslos sein
門 (もん): (1) Tor, Pforte, Tür, Einfahrt, Eingang, Schleusentor, (2) Schule, Anhängerschaft für einen Meister, (3) Klasse, Phylum, systematische Bezeichnung für Tier- od. Pflanzenstamm, (4) Zählwort für Kanonen, Tor, Türe, Eingang
歯 (は): (1) Zahn, (2) Zahn eine Zahnrades, Zinke eines Kammes, (3) Stelze der Geta, Stelze von Stelzenschuhen
大切 (たいせつ): (1) wichtig, bedeutend, bedeutsam, (2) kostbar, teuer, wertvoll, (3) geliebt, lieb, (1) Wichtigkeit, Bedeutung, (2) Kostbarkeit, (1) wichtig, bedeutend, bedeutsam, (2) kostbar, teuer, wertvoll
丁度 (ちょうど): (1) genau, exakt, passend, (2) gerade, eben, just, Punkt …, pünktlich, soeben, (3) glücklicherweise, gerade noch, (4) geradezu, genau wie
如何 (どう): (1) welche Weise, welcher Zustand, (2) wie weit, in welchem Ausmaß, wie, was, (1) wie, was, (2) auf welche Weise
どう致しまして (どういたしまして): (1) bitte schön!, gern geschehen!, keine Ursache!, bitte, (2) das macht nichts
プール: (1) Schwimmbecken, Swimmingpool, Schwimmbad, (2) Zusammenschluss von Ressourcen zu einem Pool, (3) Pool, Gewinnverteilungskartell (Zusammenlegung der Gewinne bzw. die Gewinnverteilung), (4) Pool, Poolbillard
六日 (むいか): (1) sechster (Tag eines Monats), (2) sechs Tage lang
嫌 (いや): unangenehm, eklig, unliebsam, unsympathisch, nicht mögen, widerlich, zuwider
脱ぐ (ぬぐ): ausziehen, sich ausziehen, ablegen
男 (おとこ): (1) Mann, (2) Geliebter, Liebhaber
いらっしゃいませ: (1) Willkommen!, (2) Herzlich willkommen!, (3) Bitte!, (1) Willkommen!, (2) Herzlich Willkommen! || Nur herein! (Begrüßungsformel in Geschäften und beim Empfang von Gästen)
五つ (いつつ): (1) fünf (Stück), (2) fünf Jahre alt
温い (ぬるい): lauwarm, warm, mild, mollig, (1) lauwarm, (2) nachsichtig, mild
両親 (りょうしん): Eltern, Vater und Mutter
体 (からだ): (1) Körper, Körperbau, Leib, Statur, Wuchs, (2) Gesundheit, Konstitution, Leibeskraft, körperlich, physisch, Körper, Leib, körperlich, physisch
近く (ちかく): (1) in der Nähe, nahe bei, nicht weit, (2) fast, beinahe, nahezu, in der Nähe
会う (あう): (1) sich versammeln, sich treffen, (2) sich treffen, um etw. gemeinsam zu machen, (3) passen, harmonieren, (4) übereinstimmen, (5) einträglich sein, sich lohnen, (6) sich begegnen, (7) zufällig treffen, (8) geraten in …, stoßen auf …, erfahren, erleiden, (1) geraten in … (z.B. ein Unwetter), kommen in, (2) haben (z.B. einen Unfall), treffen auf …, stoßen auf …
野菜 (やさい): Gemüse
玄関 (げんかん): (1) Eingang, Eingangshalle, Hauseingang, Tür, Flur, (2) Zugang, Eingang, Beginn, (3) gedielter Bereich vor dem Eingang eines Hauses in dem man z.B. aus der Sänfte stieg, (4) gedielter Eingangsbereich eines Hauses (in der Edo-Zeit), (5) Vorstand eines Stadtviertels
来月 (らいげつ): nächsten Monat
毎月 (まいつき): jeder Monat, jeden Monat, monatlich, jeden Monat, monatlich
下 (した): (1) untere Position, (2) unten gelegener Platz, (3) verdeckter Platz, (4) Lage in der unteren Position, (5) Unterteil, das Untere, (6) das Niedrige, das Untergeordnete, (7) Pfand, (8) (als Präfix) Vor…, Vorbereitungs…., unten, am Boden, in der Tiefe, unten, nieder, tiefstehend, untergeben, untergeordnet, unterlegen
ストーブ: Ofen
直ぐに (すぐに): (1) gleich, augenblicklich, sofort, auf der Stelle, im Handumdrehen, (2) leicht, mühelos, unschwer, (3) nahe, nächst
雪 (ゆき): Schnee, Schneefall, Yuki
コピー: (1) Kopie, (2) Durchschlag, (3) Fotokopie, kopieren, einen Durchschlag machen
開ける (あける): anfangen, anbrechen, hell werden, dämmern, leeren, leer machen, frei machen, frei halten, (1) öffnen, (2) aufschließen, (3) ausweiten, ausbreiten, (4) ein Gewerbe beginnen, (5) eine Veranstaltung eröffnen, (6) aufbrauchen, (7) frei machen, frei halten, (8) ein Loch machen, lochen, ein Loch bohren, (9) ein Loch ausweiten, (10) leeren, leer machen, ausleeren, (11) sich Zeit frei halten, Zeit frei machen, (12) hell werden, (13) beginnen (ein neues Jahr, ein Tag), (14) zu Ende gehen (Regenzeit, Trauerzeit)
スポーツ: Sport, sportlich
火曜日 (かようび): Dienstag
花瓶 (かびん): Vase, Blumenvase
ドア: Tür
彼処 (あそこ): daselbst, dort, dort drüben, dahinten, (1) dort, dort drüben, dahinten, (2) männliche und weibliche Geschlechtsorgane
秋 (あき): Herbst
海 (うみ): (1) Meer, See, (2) See, (3) etw., das wie ein Meer ist, (4) eine große Menge gleicher Dinge, (5) Vertiefung im Tuschstein
本 (ほん): Buch
飛ぶ (とぶ): springen, hüpfen, (1) fliegen, wegfliegen, (2) verstreut sein, (3) sich beeilen, schnell sein, (4) überspringen, springen, (5) sich schnell verbreiten, (6) fliehen, (7) verschwinden
暇 (ひま): (1) Zeit, freie Zeit, Muße, (2) Entlassung, Abschied, Verabschiedung, Lebewohl, Adieu, (3) Urlaub, (1) Zeit, freie Zeit, (2) Freizeit, Muße, (3) Urlaub, freie Tage, (4) Flauheit, Schwäche (des Geschäfts), (5) Zwietracht, Feindschaft, (6) günstige Zeit, Gelegenheit, (7) Zeit, um etw. zu tun, (8) Entlassung, Scheidung, frei
掃除 (そうじ): Putzen, Saubermachen, Reinemachen, Reinigung, Fegen, Aufräumen, Abstauben, sauber machen, putzen, fegen, reinigen
綺麗 (きれい): (1) Schönheit, Sauberkeit, Ordentlichkeit, (2) Vollständigkeit, (3) Fairness, Ehrlichkeit, (4) Vollständigkeit, Restlosigkeit, (1) schön, hübsch, nett, niedlich, angenehm, ansehnlich, fein, schmuck, herrlich, prächtig, charmant, (2) sauber, rein, reinlich, klar, ordentlich, (3) sauber, fair, ehrlich, (4) vollständig, völlig, ganz, gänzlich, restlos, vollkommen, völlig, vollständig, durchaus, ganz und gar, durch und durch, total
テーブル: (1) Tisch, (2) Tabelle
夕飯 (ゆうはん): Abendessen
ラジオ: (1) Rundfunk, Radio, (2) Rundfunkgerät, Radio, (3) (in Zus.) Funk…, Drahtlos…, Schnurlos…
七日 (なのか): (1) siebter (Tag eines Monats), (2) sieben Tage
今年 (ことし): dieses Jahr (Aussprache des Ausdrucks ist abhängig vom Stilim gesprochenen Japanisch würde man eher kotoshi sagen), dieses Jahr
彼方 (あちら): (1) dort drüben, (2) das da drüben, (3) Ausland, fremdes Land, (4) er, sie, dort
何時 (いつ): wann, zu welcher Zeit, wenn
大変 (たいへん): (1) ernste Sache, furchtbares Ding, (2) schwerwiegende Sache, (3) beschwerliche Sache, (4) ernst, furchtbar, schrecklich, schlimm, außerordentlich, außergewöhnlich, ungeheuer wichtig, (5) sehr, ungemein, ungewöhnlich, Ernst, (1) ernst, furchtbar, entsetzlich, (2) enorm, riesig, wahnsinnig, sehr, überaus, gewaltig, außergewöhnlich
南 (みなみ): Süden, Minami
名前 (なまえ): (1) Name, (2) Vorname, (3) dem Namen nach, nominell
台所 (だいどころ): Küche, (1) Küche, (2) Familienbudget, Haushalt
大勢 (おおぜい): große Anzahl von Menschen, viele Leute, Gedränge, eine große Menge (Menschen), viele, zahlreich, eine große Anzahl von …
赤い (あかい): (1) rot, (2) kommunistisch
余り (あまり): (1) (2) , (1) (2) (3) (4) , überschüssig, verbleibend
意味 (いみ): (1) Bedeutung, Sinn, (2) Wichtigkeit, Tragweite, Wert einer Sache, bedeuten, besagen, darstellen
誕生日 (たんじょうび): Geburtstag
暖かい (あたたかい): (1) warm, mild, (2) warmherzig, freundlich, herzlich, (1) warm, mild, (2) finanziell gut versorgt, (3) warmherzig, freundlich, herzlich 
外国人 (がいこくじん): (1) Ausländer, (2) Person mit ausländischer (nicht-japanischer) Staatsangehörigkeit
曇り (くもり): (1) Bewölkung, bewölkter Himmel, (2) Trübung, Schleier, (3) blinde Stelle, (4) Dunkel, dunkle Stelle
分かる (わかる): (1) verstehen, begreifen, auffassen, (2) wissen, erfahren, kennen, (3) sich herausstellen, (4) Sinn haben für …, (5) erkennen
来年 (らいねん): kommendes Jahr, nächstes Jahr
遅い (おそい): (1) spät, verspätet, (2) langsam
何処 (どこ): wo, irgendwo, wo, an welcher Stelle, wo
ご免ください (ごめんください): (1) Hallo, ist jemand da?, (2) Entschuldigen Sie bitte! (Ausdruck, um auf sich aufmerksam zu machen, wenn niemand zu sehen ist; z.B. in einem Geschäft oder wenn man ein fremdes Haus oder Grundstück betritt und niemanden sieht), (3) Auf Wiederhören! (Ausdruck, mit dem man ein Telefongespräch mit einem Höhergestellten beendet)
入る (はいる): (1) hineingehen, hereinkommen, (2) beinhalten, (3) eintreten, beitreten, (4) erhalten, (5) anfangen
明後日 (あさって): übermorgen
大好き (だいすき): (1) große Zuneigung, große Liebe, (2) sehr gern haben, geliebter, liebster
未だ (まだ): (1) bis jetzt, bis heute, (2) noch, noch nicht, (1) noch, immer noch, noch immer, (2) erst, (3) außerdem noch
庭 (にわ): Garten, Hof
物 (もの): (1) Ding, Sache, Gegenstand, Körper, Objekt, Materie, Substanz, Stoff, Gestalt, Vernunft, (2) Qualität, (3) jmds. Besitz, Eigentum, (4) Rede, (5) Angelegenheit, (6) Vernunft, (7) männliche Geschlechtsorgane
小さい (ちいさい): (1) klein, gering, winzig, wenig, (2) fein, delikat, zart, (3) jung, (4) unwichtig, geringfügig, (5) leise, (6) kleinlich, (7) schwach
汚い (きたない): (1) schmutzig, unsauber, unrein, schmuddelig, dreckig, (2) unordentlich, durcheinander, (3) böse, schlecht, ungerecht, unfair, (4) niederträchtig, ekelhaft, hässlich, feige, (5) unanständig, vulgär, gemein, grob, obszön, zotig, lüstern, voller Begierde, (6) geizig, geldgierig
道 (みち): (1) Straße, Weg, Pfad, Gasse, Landsträßchen, Pass, (2) Route, Strecke, Weg, Reise, Fahrt, (3) Kurs, Lauf der Dinge, (4) Moral, Gerechtigkeit, Wahrheit, Weg der Pflicht, Pflicht, moralisches Prinzip, (5) Methode, Mittel, (6) Fachgebiet
黄色 (きいろ): Gelb, (1) Gelb, (2) Farbe von Goldmünzen, gelb
大丈夫 (だいじょうぶ): (1) alles in Ordnung, sicher, zuverlässig, fest, stark, gefahrlos, ungefährlich, (2) bestimmt, gewiss, ohne Zweifel, zweifellos, (3) stattlicher Mann, in Ordnung, sicher, zuverlässig, fest, stark, gefahrlos
バス: (1) Bass, (2) Bassist, (3) Kontrabass, Bassgeige (Abk.), (1) Bus, Omnibus (wenn das Fahrzeug gemeint ist, wird mit dai台 gezählt – wenn die Busverbindungen z.B. pro Tag gemeint sind, wird mit hon本 gezählt), (2) Bus (Sammelleitung einer EDV-Anlage), Bad
箸 (はし): Essstäbchen
池 (いけ): Teich, Weiher, Bassin, Becken, Reservoir, Ike
消す (けす): (1) löschen, auslöschen, ausblasen, ersticken, (2) ausmachen, abdrehen, ausdrehen, abschalten, (3) verwischen, tilgen, streichen, auslöschen, radieren, (4) stoppen, (5) töten, liquidieren, ermorden
止まる (とまる): (1) halten, anhalten, stehen bleiben, (2) unterbrochen werden (Wasserzufuhr, Strom, Gas), (3) befestig werden, (4) haften bleiben (im Gedächtnis), (1) bleiben, sich niederlassen, sich setzen (Vogel), (2) haften bleiben (im Gedächtnis)
立派 (りっぱ): (1) herrlich, schön, ausgezeichnet, exquisit, glänzend, majestätisch, prächtig, stattlich, wunderbar, hervorragend, (2) gerecht, richtig, (3) unbestreitbar, eisern, (1) herrlich, schön, ausgezeichnet, exquisit, glänzend, majestätisch, prächtig, stattlich, wunderbar, hervorragend, (2) lobenswert, nobel, (3) gerecht, richtig, (4) unbestreitbar, eisern, sehr gut, ausgezeichnet, hervorragend, exzellent
テープレコーダー: Kassettenrekorder
自転車 (じてんしゃ): Fahrrad, Bike, Rad,  (ugs.)Drahtesel,  (schweiz.)Velo,  (obsol.)Veloziped
絵 (え): (1) Bild, Gemälde, Zeichnung, Skizze, Abbildung, Figur, Schema, (2) Malerei, Malerkunst, Vignette, Holzschnitt, Abzug, (3) Fernsehbild, Bild auf der Filmleinwand
警官 (けいかん): Polizeibeamter, Polizist
母 (はは):  (meine)Mutter
ギター: Gitarre
兄弟 (きょうだい): Brüder, (1) Brüder, (2) Verwandtschaftsbeziehung als Bruder, (3) Geschwister, Brüder und Schwestern (beinhaltet auch Halbgeschwister), (4) Verwandtschaftsbeziehung als Geschwister, (5) Schwager, Adoptivbrüder, (6) Blutsbrüder, (7) Kameraden, Genossen
兄 (あに): (1) (mein)älterer Bruder, großer Bruder (verwendet, wenn man gegenüber anderen von seinem älteren Bruder spricht), (2) Schwager, (3) älterer Mann, (4) Pflaumenbaum, Pflaume, (5) Pflaumenblüte
昼ご飯 (ひるごはん): Mittagessen
今月 (こんげつ): (1) dieser Monat, (2) diesen Monat
八日 (ようか): (1) achter (Tag eines Monats), (2) acht Tage
沢山 (たくさん): (1) viel, viele, zahlreich, (2) genug, genügend, ausreichend, viele, zahlreiche
シャワー: (1) Dusche, (2) Schauer
フィルム: Film
今晩は (こんばんは): Guten Abend!
何方 (どなた): wer
涼しい (すずしい): (1) kühl, frisch, erfrischend, (2) klar, aufgeklart
さよなら: (1) Auf Wiedersehen!, (2) Auf Wiederschauen!, (3) Leben Sie wohl!
箱 (はこ): Kasten, Kiste, Schachtel, Büchse, Dose, Karton
お菓子 (おかし): Süßigkeiten, Kuchen, Konditorwaren, Konfekt, Gebäck
もしもし: (1) Hallo!, Ist jemand dran?, (2) Entschuldigen Sie bitte
晴れ (はれ): (1) heiteres Wetter, klares Wetter, schönes Wetter, (2) Öffentlichkeit, Öffentlich-Werden, (3) hervorragende Qualität, hervorragende Leistung, heiter (Wetter)
番号 (ばんごう): Nummer
便利 (べんり): (1) Bequemlichkeit, Erleichterung, (2) praktisch, bequem, (3) Nutzen, Vorteil, bequem, praktisch, nützlich, passend, vorteilhaft, handlich
病院 (びょういん): (1) Krankenhaus, Klinik, Hospital, Ärztehaus, (2) Lazarett
醤油 (しょうゆ): Sojasoße
木曜日 (もくようび): Donnerstag
半分 (はんぶん): Hälfte, das Halbe
五 (ご): fünf, 5, fünf, fünf, der Fünfte
医者 (いしゃ): Arzt,  (med.)Doktor, praktischer Arzt, Mediziner
来週 (らいしゅう): nächste Woche
貸す (かす): (1) verleihen, leihen, ausleihen, kreditieren, (2) vermieten, verpachten, (3) Gehör leihen, Gehör schenken
銀行 (ぎんこう): Bank, Bankhaus, Sparkasse
前 (まえ): (1) vorn, vor, (2) erster Teil, vorderer Teil, (3) vor, bevor, früher, (4) Portion, Anteil, für …Personen
自分 (じぶん): (1) selbst, (2) ich, mein eigenes
ベッド: Bett
上げる (あげる): (1) hochheben, heben, anheben, hochtragen, aufsetzen, hochhalten, (2) hissen, (3) erhöhen, anheben, (4) anheben (Gesicht, Blick), (5) anführen, (6) geben, schenken, (7) einladen, einlassen, hereinbitten, bitten, bestellen, (8) zur Schule schicken, (9) auf eine höhere Schule wechseln lassen, (10) aufsteigen lassen, (11) ausrufen, (12) fassen, verhaften, (13) loben, preisen, (14) erreichen, erlangen, (15) beenden, (16) opfern, (17) ins Bordell schicken, (18) ausspucken, erbrechen, (1) heben, (2) geben, anführen, erbringen, (3) (eine Zeremonie) abhalten, (4) gefangen genommen werden, festgenommen werden, (5) gebären, (1) frittieren, braten, (2) entzünden (ein Feuerwerk), steigen lassen (z.B. einen Reklameballon), (3) hissen, (4) an Land bringen, (5) zu sich kommen lassen (eine Geisha), (6) erheben (Stimme)
面白い (おもしろい): (1) schön, (2) interessant, (3) amüsant, lustig, spaßig, ulkig, drollig, (4) angenehm, unterhaltend, unterhaltsam
どうも: (1) sehr, ziemlich, (2) irgendwie, (3) Bitte sehr!
寝る (ねる): (1) schlafen, schlafen gehen, ins Bett gehen, (2) krank im Bett liegen, (3) sich hinlegen, (4) brachliegen, unbenutzt herumliegen
夏 (なつ): Sommer
戸 (と): Tür, Schiebetür, (1) Eingang, (2) Engstelle, durch die eine Strömung fließt, (3) Meerenge, (4) Schleusentor
九つ (ここのつ): (1) neun (Stück), (2) neun Jahre alt
問題 (もんだい): (1) Frage, Aufgabe, (2) Problem, Thema, (3) Angelegenheit, Gegenstand, Sache
何方 (どちら): (1) wo, in welcher Richtung, (2) wer, (3) welcher, welcher, welche, welches
近い (ちかい): (1) nahe, nahegelegen, benachbart, in der Nähe von, (2) bald, in nächster Zeit, früh, zeitig, (3) eng, nah, innig, (4) fast, knapp, beinahe, ungefähr, (5) ähnlich, (6) kurzsichtig
先 (さき): (1) Spitze, Ende, (2) Stirn, Front, Kopf, Führung, (3) Folge, Fortsetzung, (4) etw. Ehemaliges, (5) etw. vor einem Liegendes, (6) Zukunft, früher, ehemalig, Ex…
頃 (ころ): um die Zeit, zu der …
冷たい (つめたい): kalt, kühl
黄色い (きいろい): (1) gelb, (2) grell, schrill (insbes. für Frauen- und Kinderstimmen verwendet)
回 (かい): (1) Mal, Wiederkehr, Runde, (2) …mal, (3) Spielzeit, Spielhälfte, Inning
荷物 (にもつ): (1) Gepäck, Fracht, Last, Ladung, Post, Päckchen, Paket, (2) Klamotten, (3) Last, Belastung
明日 (あした): morgen, der morgige Tag, morgen, (1) morgen, (2) Morgen, Zukunft
幾ら (いくら): (1) wie viel, wie viele, (2) kaum, nicht viel, wenig, (3) egal wie viel, wie viel auch, wie sehr auch, wie lange, wie teuer
全部 (ぜんぶ): alle, alles, alle
七つ (ななつ): (1) sieben Stück, (2) sieben Jahre alt
欲しい (ほしい): wünschen, haben wollen, wollen, begehren
ホテル: Hotel (im westlichen Stil)
靴 (くつ): (1) Schuh, Schuhe, Schuhwerk, Fußbekleidung, Stiefel, (2) (übertr.)Lager, Sockel, Auflager
目 (め): (1) Auge, Augapfel, (2) Sehkraft, Sehvermögen, Augenlicht, Gesicht, Sehen, (3) Aufmerksamkeit, Achtsamkeit, Wachsamkeit, (4) Kennerblick, Einsicht, Feingefühl, Urteilskraft, (5) Gesichtspunkt, Standpunkt, Auffassung, Denkweise, Einstellung, (6) Masche, Auge, (7) Feld, (8) Punkt, Auge, (9) Zahn, Kerbe, (10) Gewebe, Textur, Maserung, (11) Erfahrung, Erlebnis, (12) Gewicht
嫌い (きらい): (1) Abneigung, Abscheu, Antipathie, Aversion, Ekel, Hass, (2) (in den Wendungen … no kirai ga aru …の嫌いがある und … suru kirai ga aru …する嫌いがある)Neigung, Hang, Tendenz, Anflug, (3) Unterscheidung, gehasst, verabscheut
レストラン: Restaurant, Gasthaus
去年 (きょねん): letztes Jahr, letztes Jahr, vergangenes Jahr, voriges Jahr, Vorjahr
住む (すむ): wohnen, bewohnen, leben
お手洗い (おてあらい): Toilette, WC (höfl.)
切符 (きっぷ): Karte, Fahrkarte, Eintrittskarte, Flugschein, Konzertkarte, Ticket
宿題 (しゅくだい): (1) Hausaufgabe, Schularbeiten, (2) eine offene Frage
朝 (あさ): Morgen, früher Morgen, (1) Morgen, Morgendämmerung, (2) Vormittag, am Morgen
高い (たかい): (1) hoch, groß, lang, großgewachsen, (2) teuer, kostbar, kostspielig, (3) laut, (4) hochgestellt, vornehm, edel, (5) scharf, genau, tief, (6) hoch, schrill, (7) berühmt, berüchtigt
水曜日 (すいようび): Mittwoch
二人 (ふたり): zwei (Personen)
カメラ: Kamera
皆 (みな): (1) alle, jeder, (2) alles
魚 (さかな): Fisch, Fische, Fisch
晩御飯 (ばんごはん): Abendessen
白い (しろい): (1) weiß, (2) grau (bei Haaren), (3) leer, unbeschrieben (Papier), (4) ungefärbt, sauber, unverschmutzt, (5) rein, unschuldig, unverdächtig, (6) hell, strahlend, (7) laienhaft, ungeschliffen, (8) klar, deutlich, offensichtlich
座る (すわる): (1) sitzen, sich setzen, sich hinsetzen, sich niedersetzen, (2) Platz nehmen, (3) einen Rang einnehmen, (1) starr sein, fest sein, (2) ruhig sein
歌 (うた): (1) Lied, Gesang, Ballade, (2) Gedicht, Poesie, (3) Waka, Tanka, (4) Volkslied, Schlager
店 (みせ): Geschäft, Laden, Restaurant, Café, Bar, Bude
今朝 (けさ): heute Morgen
曇る (くもる): (1) sich bewölken, wolkig werden, bewölkt werden, (2) sich trüben, sich verfinstern, trübe werden, finster werden
千 (せん): Sen, tausend, 1000
取る (とる): (1) nehmen, ergreifen, fassen, fangen, packen, besetzen, erobern, (2) reichen, (3) sammeln, ernten, pflücken, fangen, finden, machen, (4) bekommen, erhalten, empfangen, annehmen, gewinnen, (5) erwählen, auswählen, vorziehen, (6) holen, kaufen, sich nehmen, bestellen, (7) stehlen, wegnehmen, (8) zu sich nehmen, (9) gewinnen, (10) älter werden, (11) zu sich nehmen, einnehmen, essen, fressen, fordern, verlangen, (12) brauchen, in Anspruch nehmen, erfordern, bedürfen, (13) beseitigen, entfernen, (14) nehmen, meinen, verstehen, (15) führen, verwalten, (16) behalten, aufheben, (17) abonnieren, subskribieren, reservieren, buchen
勉強 (べんきょう): (1) Studium, Studien, Lernen, Forschen, (2) Fleiß, Eifer, (3) Preisnachlass, Rabatt, (1) studieren, lernen, pauken, untersuchen, (2) fleißig sein, sich bemühen, (3) den Preis ermäßigen, Rabatt geben
歳 (さい): (1) Talent, Begabung, Genie, Fähigkeit, (2) Sai (Hohlmaß von ein Zehntel Koku = ca. 28 lbzw. Holzmaß von 1 shaku mal 1 shaku mal 6 shakubzw. ein Zehntel Shaku = 0,0018 l), (3) (als populäres Abkürzungszeichen für dai 第)… Jahre, … Jahre alt
階段 (かいだん): (1) Treppe, Stufe, Leiter, Treppenhaus, Stiege, (2) Reihenfolge, Stufenfolge, Ordnung, Phase
上手 (じょうず): (1) Geschicklichkeit, Meisterschaft, Gewandtheit, (2) Erfahrener, Geübter, Experte, (3) Kompliment, Schmeichelei, geschickt, gewandt, erfahren, meisterhaft, sachverständig, gut, gut, geschickt, gewandt, sachverständig
置く (おく): (1) setzen, legen, stellen, dalassen, lassen, zurücklassen, ordnen, (2) aufhören, ablassen, fallen lassen, (3) halten, anstellen, engagieren, (4) beherbergen, unterbringen, einlogieren, (5) errichten, eröffnen, etablieren, organisieren, (6) ernennen, (7) stationieren, aufstellen
鞄 (かばん): (1) Tasche, Aktentasche, Reisetasche, (2) Ranzen, Schulranzen
美味しい (おいしい): (1) schmackhaft, wohlschmeckend, lecker, (2) gut, attraktiv, vorteilhaft
朝ご飯 (あさごはん): Frühstück
呼ぶ (よぶ): (1) rufen, (2) schreien, Alarm schlagen, (3) zu sich rufen, kommen lassen, engagieren, (4) einladen, hereinrufen, (5) nennen, anreden, benennen, (6) anziehen, sammeln, (7) hervorrufen, erwecken, verursachen
今 (いま): (1) (2) (3) 
出かける (でかける): ausgehen, fortgehen, außer Haus gehen, losgehen, sich auf den Weg machen, abfahren, abreisen, aufbrechen
乗る (のる): (1) steigen, besteigen, aufsitzen, (2) einsteigen (in ein Auto, einen Bus), nehmen, benutzen, fahren mit …, fliegen mit …, (3) auf etwas steigen, auf etw. treten, sich auf etw. stellen, (4) sich beteiligen, sich einlassen auf, sich anschließen, (5) auf etw. hereinfallen, auf jmdn. hereinfallen, ins Garn gehen, auf den Leim gehen, (6) im Zuge sein, (7) teilnehmen
撮る (とる): aufnehmen, aufzeichnen (Musik oder Film mit einem Rekorder), aufnehmen, drehen, eine Aufnahme machen, ein Foto machen (mit einer Kamera)
ではまた: Bis dann! Tschüss
飲む (のむ): (1) etw. in den Mund nehmen und ungekaut zur Speiseröhre weiterschicken, trinken, (2) herunterschlucken, verschlingen, (3) einnehmen, nehmen, (4) einatmen, aspirieren, (5) rauchen, (6) unterdrücken, nicht hinauslassen (Stimme, Weinen, Trauer etc.), (7) überwältigen, (8) unterschätzen, (9) aufnehmen, annehmen, (10) verschwinden lassen, (11) verstecken, (12) makeln, buchmachen, (13) Nomu-Gesangstechnik
咲く (さく): blühen
作る (つくる): (1) machen, erzeugen, hervorbringen, herstellen, produzieren, anfertigen, schaffen, bilden, formen, gestalten, (2) anbauen, (3) komponieren, (4) bilden
作文 (さくぶん): Aufsatz
狭い (せまい): (1) klein, (2) eng, schmal, (3) beengt, eingeengt, begrenzt, beschränkt, (4) kleinlich, engherzig
頭 (あたま): (1) Kopf, Haupt, (2) Chef, Boss, Meister, (1) Kopf, Haupt, (2) Intelligenz, Köpfchen, Verstand, (3) Kopfhaare, (4) Gipfel, Spitze, (5) Vorstand, (6) Anfang, Beginn, vorne, (7) Personenzahl, Anzahl (von Menschen), Kopfzahl
お弁当 (おべんとう): (1) Bentō, O-Bentō, Imbiss zum Mitnehmen, Lunchpaket, Verpflegungspaket, mitgebrachtes Essen, (2) am Mund haftender Essenrest, am Mund klebendes Reiskorn
二十日 (はつか): (1) zwanzigster Tag (eines Monats), Zwanzigster, (2) zwanzig Tage
宜しく (よろしく): (1) angemessen, passend, geeignet, (2) Sehr erfreut!, (3) Seien Sie so freundlich!, (4) Viele Grüße an …
仕事 (しごと): (1) Arbeit, Beruf, Beschäftigung, Geschäft, (2) Arbeit (Produkt aus Kraft mal Weg; Zeichen: W), (3) Näharbeit, (4) Handlung, Tat, (5) Untat (shi ist Renyō・kei von suru; 仕 ist Ateji), arbeiten
初めて (はじめて): zum ersten Mal, das erste Mal
春 (はる): (1) Frühling, Frühjahr, (2) Lebensfrühling, (3) Pubertät
図書館 (としょかん): Bibliothek, Bücherei
じゃあ: also dann, also, nun, dann
水 (みず): (1) Wasser, kaltes Wasser, (2) Hochwasser, Flut, Überschwemmung, (3) Flüssigkeit, (4) Pause
其の (その): (1) dieser, der, sein, (2) der betreffende, der fragliche, der besagte, (3) genau derselbe
より: (1) als, (2) ausgehend von …, (3) außer, (4) besser, schlechter
食べ物 (たべもの): Essen, Speise, Lebensmittel, Nahrung
安い (やすい): billig, preiswert, friedlicher Schlaf, ruhiger Schlaf
横 (よこ): (1) Seite, Breite, (2) Seite, Flanke, Körperseite, (3) Außenseite, (4) etw. Inkorrektes, (5) Schuss, Einschuss, SchussfadenQuerfaden
履く (はく): an der Hüfte tragen (Schwert etc.), anziehen (Schuhe, Strümpfe, Hose etc.), anziehen, anhaben, an den Füßen tragen
眼鏡 (めがね): Brille, Gläser, (1) Brille, Augenglas, (2) Urteilsfähigkeit, Urteilsvermögen, Urteil, Einsicht, Kennerblick, geistiges Auge, (3) (Abk. f.)Fernrohr, (4) Megane (Mädchenfrisur mit auf der Stirn getragenen Schleifen; v.a. während der Edo-Zeit), (5) (Abk. f.)Doppelbogenbrücke
食堂 (しょくどう): (1) Speisezimmer, Esszimmer, Speisesaal, (2) Restaurant, Kantine, Mensa
燐寸 (マッチ): (1) Streichholz, Zündholz, (2) Streichholzschachtel, Streichholzbriefchen
明るい (あかるい): (1) hell (z.B. Zimmer), licht, (2) heiter (z.B. Charakter), froh, fröhlich, (3) kundig, vertraut, beschlagen, bewandert, (4) sauber
パーティ: (1) Party, Fete, (2) Partei
家庭 (かてい): (1) Familie, Haushalt, (2) Zuhause, Heim, Wohnung, Haus, Heim…, Haus…
言う (いう): (1) sagen, sprechen, aussprechen, äußern, reden, sich unterhalten, (2) mitteilen, melden, erzählen, (3) erklären, aussagen, offenbaren, angeben, versichern, behaupten, gestehen, anerkennen, klagen über, (4) ausdrücken, äußern, aussprechen, beschreiben, darstellen, bedeuten, meinen, (5) nennen, heißen, zu sein behaupten, (6) (einen Laut machen), bellen, knurren, miauen, schnurren, krächzen, (7) befehlen, hinweisen, (1) sagen, äußern, aussprechen, reden, sich unterhalten, (2) mitteilen, melden, erzählen, (3) erklären, aussagen, offenbaren, angeben, versichern, behaupten, gestehen, anerkennen, klagen über, (4) ausdrücken, äußern, aussprechen, beschreiben, darstellen, bedeuten, meinen, (5) nennen, heißen, (6) sprechen, reden
煙草 (たばこ): (1) Tabak, (2) Zigarette, Zigarre, (3) Tabakpflanze, Nicotiana tabacum
彼の (あの): jenes, jener, das … dort, der … dahinten, jener, jene
死ぬ (しぬ): (1) sterben, hinscheiden, verscheiden, den letzten Atem aushauchen, versterben, umkommen, verenden, fallen, (2) gefangen sein, (3) aus dem Spiel genommen werden
家族 (かぞく): (1) Familie, (2) Familienmitglieder eines Hauses unter der Leitung des Familienvorstandes (nach dem Familien- und Erbrecht bis 1947)
一昨年 (いっさくねん): vorletztes Jahr, vorvoriges Jahr
多分 (たぶん): (1) wahrscheinlich, vermutlich, wohl, möglicherweise, hoffentlich, (2) eine Menge, viel, eine Menge, viel
丈夫 (じょうぶ): (1) gesund, kräftig, (2) unverwüstlich, haltbar, dauerhaft, stabil, solide, (3) richtig, angemessen, passend. (ursprüngl. Bed.: Mann von ca. 180 cm; die anderen Bed. sind davon abgeleitet), (1) gesund, kräftig, (2) haltbar, dauerhaft, haltbar, stabil, solide, unverwüstlich, (3) richtig männlich
火 (ひ): (1) Feuer, Flamme, Funke, (2) Brand, Feuersbrunst, (3) Feuerchen, Lagerfeuer, Feuer, (4) Licht, Beleuchtung, (5) Hitze, (6) Gruppe aus zehn Soldaten (nach dem Ritsuryō-System)
冬 (ふゆ): Winter, Winterzeit
外国 (がいこく): Ausland, im Ausland, ausländisch, fremd, fremdartig, exotisch
九 (きゅう): neun, neun, 9, neun
掛かる (かかる): (1) hängen, herabhängen, (2) überhängen, hinüberragen, (3) in der Luft hängen, in der Luft stehen, (4) aufs Feuer stellen, (5) wiegen, (6) sich anlehnen, sich stützen, (7) gefangen werden, hängen bleiben, (8) Sorgen machen, (9) abschließen, (10) bedeckt werden, ausgesetzt werden, (11) begießen, (12) behelligen, belästigen, auferlegt werden, (13) wecken (einen Verdacht, Hoffnung), (14) ansprechen, (15) einen Fluch auferlegen, (16) hinzufügen, (17) brauchen, in Anspruch nehmen, kosten, erfordern, (18) auferlegt bekommen, (19) gebaut werden (eine Brücke), gezogen werden (eine Leitung), (20) angerufen werden, (21) berühren, anfassen, (22) behandelt werden, untersucht werden, einen Arzt konsultieren, sich an einen Arzt wenden, (23) treffen, sehen, (24) starten, anfangen, beginnen, (25) anlangen, (26) dauern, kosten, (27) erreichen, (28) in Beziehung stehen, (29) sich beteiligen, (30) errichten, (31) überlassen, (32) nötig sein (Arbeit, Geld), (33) sich entgegenstellen, angreifen, herfallen, (34) sich paaren, (35) Arbeit beginnen, (36) treffen, begegnen
喫茶店 (きっさてん): Teehaus, Café, Kaffeehaus
無い (ない): (1) nicht sein, ohne sein, (2) nicht vorhanden sein, weg sein, (3) nicht haben, (4) fehlen, ohne etw. sein, (5) nicht (Negationsendung), gestorben, verstorben, tot
七 (しち): sieben, 7
果物 (くだもの): Obst, Frucht
電車 (でんしゃ): (1) (elektrische)Bahn,  (elektrischer)Zug, (2) S-Bahn, Stadtbahn, (3) Straßenbahn, Trambahn, die Elektrische
寒い (さむい): (1) kalt, frostig, (2) vor Schrecken zittrig, (3) unzufrieden, gefühlskalt, (4) armselig, (5) miserabel, dürftig, unbefriedigend, unangemessen (häufig in der Form o・samui verwendet)
大きい (おおきい): (1) groß, gewaltig, mächtig, (2) riesig, gigantisch, immens, ungeheuer, (3) laut, (4) dick
切る (きる): (1) schneiden, aufschlitzen, (2) abschneiden, kreuzen, durchschneiden, (3) ausschalten, abstellen, (4) abbrechen, auflegen, (5) unterschreiten, (6) stechen, übertrumpfen (im Kartenspiel), (7) mischen (Karten)
封筒 (ふうとう): Umschlag, Briefumschlag, Kuvert
降る (ふる): regnen, schneien, fallen (Schnee, Regen)
姓 (せい): Familienname
漢字 (かんじ): Kanji, chinesisches Schriftzeichen, sinojapanisches Schriftzeichen
彼 (あれ): (1) das dort, jenes, (2) männliche Geschlechtsorgane, (3) die Periode einer Frau
出る (でる): (1) hinausgehen, herauskommen, erscheinen, sich zeigen, auftreten, auftauchen, hervorgehen, in Erscheinung treten, (2) hinausgehen, fortgehen, spazieren gehen, (3) anwesend sein, beiwohnen, mitmachen, besuchen, (4) herausfließen, herausquellen, (5) hervorsprießen, emporsprießen, keimen, (6) ausbrechen, entstehen, (7) teilnehmen, (8) veröffentlicht werden, herausgegeben werden, (9) stehen, geschrieben stehen, (10) sich einmengen, sich einmischen, einschreiten, (11) abgehen, verlassen, aufbrechen, weggehen, abreisen
四つ (よっつ): vier, (1) vier, (2) vierJahre (alt), (3) zehn Uhr morgens, zehn Uhr abends (alte Zeitangabe), (4) Kreuzgriff, (5) (diskriminierende Bez. f.)Mitglied der untersten Schicht
洋服 (ようふく): Kleidung (insbes.) westliche Kleidung, Anzug
服 (ふく): (1) Kleid, Kleidung, (2) Anzug, (3) Dosis
紅茶 (こうちゃ): schwarzer Tee, Schwarztee
番 (ばん): (1) Wache, Aufsicht, Dienst, (2) Reihe, (3) Nummer …
冷蔵庫 (れいぞうこ): Kühlschrank, Eisschrank
部屋 (へや): (1) Zimmer, Raum, Wohnung, Gemach, Stube, Kajüte, (2) Sumō-Trainingszentrum
側 (そば): (1) Seite, Nähe, Nachbarschaft, (2) sofort, gleich danach, (1) Seite, Nähe, Rand, (2) am Rand Stehender, Außenstehender, Unbeteiligter, Dritter
友達 (ともだち): Freund, Freundin
お茶 (おちゃ): (1) Tee, grüner Tee, (2) Teezeremonie, Teekult, (3) Teepflanze, Teestrauch
土曜日 (どようび): Samstag, Sonnabend
毎週 (まいしゅう): jede Woche, wöchentlich
人 (ひと): (1) Mensch, Person, Leute, (2) andere, jemand, irgend einer, man, die Leute, (3) Erwachsener, Charakter, Natur, Persönlichkeit, (4) Mensch, Homo sapiens sapiens
見る (みる): betrachten, anschauen, (1) sehen, schauen, gucken,  (norddt.) kucken, (2) anschauen, ansehen, anblicken, betrachten, (3) lesen, durchsehen, (4) erblicken, bemerken, (5) betrachten, beobachten, (6) betrachten und inhaltlich verstehen, (7) mit ansehen, zusehen, zuschauen, (8) anstarren, (9) besichtigen, (10) ansehen als …, (11) überprüfen, nachschlagen, (12) beurteilen, bewerten, (13) auf etw. achten, sich um etw. kümmern, (14) betreuen, sich um jmdn. kümmern, (15) erfahren, eine Erfahrung machen, (16) verwirklichen, (17) treffen (bes. jmdn. des anderen Geschlechtes), Umgang haben, (18) als Ehepaar leben, (19) (nach te-Form) versuchen
廊下 (ろうか): (1) Korridor, Flur, Foyer, Galerie, Diele,  (überdachter)Gang, (2) Engpass, enge Schlucht
料理 (りょうり): (1) Kochen, Kocherei, Kochkunst, Küche, Speise, Gericht, (2) Umgang, Handhabung, (1) kochen, (2) umgehen mit …
行く (いく): (1) gehen, sich begeben, fahren, reisen, fliegen, kommen, (2) fortgehen, weggehen, weglaufen, sich entfernen, abfahren, abreisen, abhauen, (3) besuchen, aufsuchen, vorsprechen, vorbeikommen, (4) zu Fuß gehen, laufen, (5) zu Ende gehen, (6) kommen, einen Orgasmus haben, (1) gehen, sich begeben, fahren, reisen, fliegen, kommen, (2) fortgehen, weggehen, weglaufen, sich entfernen, abfahren, abreisen, abhauen, (3) besuchen, aufsuchen, vorsprechen, vorbeikommen, (4) zu Fuß gehen, laufen, (5) zu Ende gehen, sterben, verscheiden
夕べ (ゆうべ): gestern Abend, letzte Nacht, Abend, Yū, Abend, letzte Nacht, gestern Abend, gestern Nacht, diese Nacht, heute Nacht
口 (くち): (1) Mund, Maul, Schnauze, (2) Sprache, Sprechen, (3) Mündlichkeit, (4) Gerücht, Gerede, (5) Sprechweise, (6) Essen und Trinken, (7) Genuss beim Essen, Geschmack, (8) Zahl der mit Nahrung zu versorgenden Münder, (9) Broterwerb, Beschäftigung, Stellung, (10) Öffnung, Loch, Schnabel, Mundstück, (11) Fassspund, Zapfen, Hahn, (12) Beginn, Anfang, (13) Sorte, (14) Gebiss, als Gebiss dienendes Seil
黒 (くろ): (1) Schwarz, schwarze Farbe, (2) schwarzer Stein, (3) Schuld, Verdacht
猫 (ねこ): (1) Katze, Kater, Kätzchen, (2) Shamisen, (3) passiver Part beim Geschlechtsverkehr
どんな: was für ein, was für eine Art von, welches
昼 (ひる): (1) Mittag, (2) Tag, tagsüber, (3) Mittagessen, zu Mittag, zur Mittagszeit
練習 (れんしゅう): Übung, Einübung, Schulung, Training, Probe, Drill, üben, trainieren
一昨日 (おととい): vorgestern, (1) vorgestriger Tag, (2) vorgestern, vor zwei Tagen, vorgestern
広い (ひろい): (1) weit, ausgedehnt, großräumig, geräumig, groß, (2) breit, umfangreich, umfassend, (3) weit geöffnet, offen, (4) verbreitet, (5) großherzig, tolerant, (6) zahlreich
歩く (あるく): gehen, zu Fuß gehen, laufen
結婚 (けっこん): Heirat, Eheschließung, Hochzeit, Vermählung, heiraten, sich verheiraten, die Ehe schließen, die Ehe eingehen, sich vermählen, sich trauen lassen, jmdn. zur Frau nehmen, jmdn. zum Mann nehmen, ehelich, Hochzeits…, Heirats…
暑い (あつい): heiß, warm (Lufttemperatur)
私 (わたし): ich (vertraulicher als watakushi), (1) ich, (2) privat, mir, (1) mein, (2) privat, persönlich
先週 (せんしゅう): letzte Woche
後 (あと): (1) hinter, nach, in, (2) später, folgend, (1) rückwärtige Richtung, (2) hinten, rückwärts, (3) später, danach, nach, nachher, nachdem, (4) spätere Situation, (5) Ergebnis, (6) Rest, (7) zurückgebliebene Empfindung, (8) Nachkomme, Nachfahre, Nachkommenschaft, (9) Nachfolger, (10) vorher, (11) weitere …, (1) hinterer, rückwärtig, (2) späterer, folgender, zukünftiger, nachherig, (3) übrig bleibend, zurückbleibend
辛い (からい): (1) scharf, stark gewürzt, gepfeffert, (2) prickelnd, trocken (Wein), (3) salzig, gesalzen, (4) streng, strikt, hart
日本語 (にほんご): Japanisch, japanische Sprache, japanisch
平仮名 (ひらがな): Hiragana, japanisches Silbenschriftzeichen
隣 (となり): Nachbarschaft, Nähe, Haus nebenan, Platz nebenan, der nächste Platz, Ort nebenan, nebenan, benachbart
押す (おす): (1) stoßen, schieben, drängen, (2) drücken, pressen, (3) prägen, (4) abstempeln, siegeln, (5) vergolden, (6) anschieben (z.B. einen Wagen), (7) drücken (ein Ruder), (8) sich vergewissern, sich versichern, (9) sich dem Ende nähern, (10) vorrücken (eine Armee), (11) zwingen, drängen, (12) ausüben, ausdehnen, zufügen
本棚 (ほんだな): Bücherregal, Bücherbrett
どうも有難うございます (どうもありがとうございます): Herzlichen Dank!
晴れる (はれる): (1) aufklaren, sich aufklären, aufheitern, klar werden, (2) sich zerstreuen (z.B. Bedenken, ein Verdacht, Zweifel), (3) heiter werden, sich wieder erheitert fühlen, in guter Stimmung sein
違う (ちがう): (1) anders sein, verschieden sein, sich unterscheiden, (2) nicht stimmen, falsch sein, (3) sich irren, (4) nein, nicht, (5) ändern
有る (ある): (1) sein, vorhanden sein, existieren, stehen (z.B. Möbel), liegen (z.B. Bleistift), (2) sich befinden, (3) haben, besitzen, (4) stattfinden
シャツ: Unterhemd, Hemd, T-Shirt, Strickhemd
授業 (じゅぎょう): Unterricht, unterrichten, Unterricht geben, Stunden geben
何故 (なぜ): warum, weshalb, weswegen, aus welchem Grund
テスト: Test, Probe, Prüfung, Quiz, prüfen, testen, erproben
新しい (あたらしい): (1) neu, nagelneu, (2) frisch, (3) neuartig, zeitgemäß, modern
食べる (たべる): (1) essen, speisen, zu sich nehmen, fressen, probieren, (2) leben von
否 (いいえ): nein, Nein, (1) (2) 
毎日 (まいにち): jeden Tag, jeder Tag, täglich
毎朝 (まいあさ): jeder Morgen, jeden Morgen, allmorgendlich
買い物 (かいもの): Einkauf, Besorgung, Einkaufen
姉 (あね):  (meine) ältere Schwester, größere Schwester (verwendet, wenn man gegenüber anderen von der eigenen älteren Schwester spricht)
映画館 (えいがかん): Kino, Filmtheater, Lichtspielhaus
一番 (いちばん): (1) erste Position, (2) Erster, Nummer eins, (3) Bester, (4) ein Theaterstück, (5) eine Partie (z.B. Go od. Shōgi), (6) ein Stück, (7) überaus, sehr, (8) am besten, am meisten, (9) versuchsweise, (10) entschlossen, (11) zunächst, erster, bester
靴下 (くつした): Socken, Strümpfe
ボールペン: Kugelschreiber
強い (つよい): (1) stark, kraftvoll, kräftig, gewaltig, heftig, (2) widerstandsfähig, nicht anfällig, robust, gesund, rüstig, (3) psychisch belastbar, tapfer, mutig, (4) wirkungsvoll, tief, tiefgehend, mächtig, (5) fähig, kenntnisreich, geschickt, begabt, (6) aufmerksam, zuverlässig, fest
ゆっくり: (1) langsam, allmählich, schrittweise, ohne Eile, ohne Hast, zögernd, schleppend, (2) mit Muße, in aller Ruhe, mit viel Zeit, (3) bequem, gemütlich, behaglich, ruhig, zwanglos, sich Zeit lassen, es ruhig angehen lassen, langsam, gemächlich
八 (はち): acht, acht, 8
葉書 (はがき): Postkarte
零 (れい): (1) Null, (2) nichts, kein einziger, (3) Anfang, Nullpunkt, (4) Null, Versager, Null, null
駅 (えき): (1) Bahnhof, Station, (2) Raststation einer Landstraße (im Ritsuryō-System eingeführt)
其れでは (それでは): (1) dann, in diesem Fall, wenn das so ist, wenn das der Fall ist, (2) nun, also
木 (き): Schlaghölzer, (1) Baum, (2) Holz
